digital era threatens tenuous future of drive-ins	digital era threatens future of drive-ins
jessica lal murder convict manu sharma gets 15-day parole	jessica murder manu sharma gets parole
un to hold emergency dr congo talks	u.n. council to hold emergency dr congo talks
iran and iaea resume nuclear talks	iran , iaea resume nuclear talks in tehran
thai protesters storm army headquarters	thai protestors storm royal army headquarters in bangkok
40 still missing in deadly canada oil train ...	40 still missing in deadly canada oil train crash
raghuram rajan to step into eye of rupee storm	raghuram rajan to step into eye of rupee storm as rbinbspguv tomorrow
iran foreign ministry to lead nuclear talks	iran foreign minister tasked with nuclear talks
de blasio sworn in as new york mayor , succeeding bloomberg	bill de blasio sworn in as new york mayor , succeeding michael bloomberg
us presses iraq on reports of arms deal with iran	united states presses iraq on reports of arms deal with iran
narendra modi appointed pm , swearing-in on may 26	modi appointed pm , swearing-in on may 26
minn. man claims share of $ 448m powerball jackpot	minn. dad claims third of $ 448m powerball jackpot
driver backs into stroller with child , drives off	driver backs into mom , stroller with child then drives off
george zimmerman arrested after disturbance call	george zimmerman arrested in florida after disturbance call
halliburton pleads guilty to destroying gulf spill evidence	gulf of mexico oil spill : halliburton pleads guilty to destroying evidence
spain princess testifies in historic fraud probe	spain princess testifies in historic fraud probe
more mh17 bodies leave ukraine	more flight mh17 bodies leave ukraine
lewis hamilton holds off nico rosberg in thrilling spanish grand prix	lewis hamilton holds off nico rosberg to claim spanish grand prix
us-russia reach agreement on syria	us-russia reach agreement on syria weapons
tsa drops effort to allow small knives on planes	tsa drops plan to allow small knives on planes
snowden leaves moscow airport	edward snowden leaves moscow airport
morsi supporters rally in egypt , army shows muscle	mursi supporters rally in egypt , army shows muscle
us stocks edge up after positive economic reports	stocks edge higher after positive economic reports
bachelet set for big win in two-woman poll showdown	bachelet set for big win in chile 's 2-woman poll showdown
north korea proposes high-level talks with us	north korea offers ' high-level talks ' with us
senate confirms obama nominee to key appeals court	senate approves obama nominee to key appeals court
bangladesh sentences british , us citizen to hang	bangladesh sentences british muslim and us citizen to hang
n korea launches three short-range guided missiles	north korea launches three short-range missiles
obama begins africa trip in senegal	obama begins africa tour in senegal
beverly hills demands brunei sultan sell hotel	protests as beverly hills demands brunei sultan sell hotel
britain aims to be first western country to issue islamic bond	britain to be first western country to issue sovereign islamic bond
angelina jolie 's aunt dies of breast cancer	angelina jolie 's aunt dies of breast cancer
bangladesh factory collapse owners arrested	bangladesh factory owners arrested
apple files for ' iwatch ' trademark	apple files for ' iwatch ' trademark in japan
quick crossword - friday 31st may	classic crossword - friday 31st may
assad says syria will allow access to chemical sites	assad : syria will allow access to chemical sites
maple leafs top canadiens for 4th straight win	maple leafs edge canadiens for 4th straight win
benetton , new retailers to sign bangladesh safety pact	benetton agrees to sign bangladesh safety pact
rolf harris charged with child sex offences	harris charged with 13 child-sex offences
abdullah abdullah widens lead in afghan presidential vote	abdullah widens lead in afghan presidential poll
7.2 quake hits central philippines , killing 6	7.2 quake hits central philippines , killing 85
israel ' resumes gaza offensive'	israeli army resumes gaza offensive
berlusconi expelled from italian senate	berlusconi expelled from italian parliament
israel shoots down rocket near egypt 's border	israel downs rocket near egypt border
u.n. rights chief presses egypt on mursi detention	un rights chief presses egypt on morsi detention
'fast & amp ; furious ' star paul walker dies in car crash	'fast & amp ; furious ' star dies in car crash
obama says he 's having a ' great time ' on vacation	obama says he 's having a ' great time ' on vacation
liquid ammonia leak kills 15 in shanghai	ammonia leak kills 15 in shanghai
hong kong rally organisers arrested	hong kong democracy rally organisers arrested
eu foreign ministers to discuss egypt violence	eu foreign ministers to discuss egypt on wednesday
google agrees to sell motorola to lenovo	google poised to sell motorola to lenovo
scores dead , 1,000 injured in china earthquake	dozens dead , 1,000 injured in china quake
us senate confirms janet yellen as us federal reserve chief	senate confirms janet yellen as next federal reserve chair
heavy smog hits north china city , flights cancelled	heavy smog hits north china city , flights canceled
bombs and gun battle kill at least 16 in somali capital	bombs and gunbattle kill at least 4 in somali capital
un rights council launches sri lanka war crimes probe	u.n. rights council launches sri lanka war crimes probe
north west mining royalties misused , says inquiry report	north west mining royalties misused - report
syrian rebel groups battle each other in north	syrian rebel groups battle each other in north
pope francis to make first visit to holy land	pope francis announces first visit to holy land
chemicals weapons watchdog opcw wins nobel peace prize	chemical arms watchdog wins nobel peace prize
heineken h1 profits fall on lower sales volumes	heineken profits fall on lower sales
un to vote on mh17 resolution	un vote on aust mh17 resolution
nelson mandela dies aged 95 new	nelson mandela dies at age 95
mayawati demands president 's rule in kashmir	mayawati demands presidents rule in jammu and kashmir
quiz crossword - friday 31st may	cryptic crossword - friday 31st may
egypt bans muslim brotherhood	egyptian court bans muslim brotherhood
tokyo wins race to host 2020 olympic games	tokyo to host 2020 olympic games
uganda 's president signs anti-gay bill	uganda 's president signs harsh anti-gay law
manchester city win premier league title	manchester city win english premier league title
angelina jolie 's aunt dies of breast cancer	angelina jolie 's aunt dies from breast cancer
rocks , tear gas fly as thai protests heat up	rocks , tear gas fly as thai protests heat up
boston bombing suspect buried in virginia	boston bomb suspect buried in virginia cemetery
boston bombing suspect buried in virginia	boston marathon bomb suspect buried in virginia
iran and un sign agreement on syria assistance	iran and un discuss agreement on syria assistance
u.n. inspectors arrive in damascus on chemical weapons hunt	un inspectors arrive in damascus on chemical probe
obama cancels moscow meeting with putin	obama canceled meeting with putin
six dead in philippine restaurant blast	6 killed in philippines restaurant blast
egypt ' freezes muslim brotherhood assets'	egypt freezes muslim brotherhood funds
man arrested outside john kerry 's house in us	man arrested outside john kerry 's house in mass .
bryan cranston will return as walter white for breaking bad spin off , report claims	bryan cranston to return as walter white for breaking bad spin off
six cambodian opposition party members charged with insurrection	six cambodian opposition politicians charged with insurrection
china army newspaper hits out at us 's prism programme	china army newspaper slams us 's prism program
silvio berlusconi expelled from italy 's parliament	silvio berlusconi expelled from parliament
tokyo to host 2020 olympic games	tokyo to host 2020 games
japan upper house vote to set ruling bloc 's power	japan upper house vote to set ruling bloc 's power
edl leaders arrested during march to woolwich	edl leaders arrested on way to woolwich
mass grave outside mexico city	mass grave found near mexico city
snowden 's hopes of leaving airport dashed	fugitive snowden 's hopes of leaving moscow airport dashed
airasia x hopes to raise up to $ 372 million from ipo	airasia chief hopes to raise up to $ 300 mn from ipo
obama signs bill aimed at blocking iran 's un envoy	obama signs law aimed at barring iran un envoy
death toll from egypt political violence rises to 421	death toll from egypt violence rises to 525
thai prime minister to dissolve parliament	thai prime minister dissolves parliament
michael schumacher is in a stable condition - according to his manager sabine kehm	michael schumacher is in a stable condition in hospital - according to his manager
turkish police storm taksim square	turkish police clear taksim square
conservative leader abbott expected to win australia election	conservative leader abbott sweeps into power in australian elections
karzai says afghanistan will not be a repeat of iraq	karzai says afghanistan won 't be a repeat of iraq
wing walker pilot die in crash at us air show	wing walker , pilot die in biplane crash at ohio air show
child abuse videos will be wiped from web	child abuse images to be wiped from web
mandela laid to rest	nelson mandela laid to rest
texas senator still filibustering abortion bill	texas senator filibusters against abortion bill
rfk killer moved to new prison on anniversary of jfk assassination	rfk killer sirhan sirhan moved to another prison -- on anniversary of jfk assassination
australia returns asylum seekers to sri lanka	australia returns asylum seekers to sri lanka in sea transfer
us capitol in washington in lockdown after shots fired	us capitol hill on lockdown after shots fired
two killed in bahrain car explosion	two killed in bahrain car blast
chemical arms watchdog wins nobel peace prize	global chemical watchdog wins nobel peace prize
tropical storm andrea heading for north florida	tropical storm andrea bearing down on florida
syria hands over last of declared chemical weapons , monitor says	watchdog : syria hands over last of its declared chemical weapons
egypt 's sisi sworn in as president	egypt 's el-sissi sworn in as president
soccer ref punched by player dies	soccer referee punched by player in utah dies
ukraine says insurgents attack border guards	ukraine crisis : insurgents attack border guards
suicide car bomb kills 30 in baghdad cafe-police , medics	suicide car bomb kills 30 in baghdad cafe
obama pressures republicans to raise debt ceiling , end shutdown	obama pressures republicans to raise the debt ceiling
north korea to restart yongbyon nuclear reactor	north korea says to restart nuclear reactor
top judge mansour sworn in as egypt interim president	justice adly mansour sworn in as egypt interim president
british actor bob hoskins dies at 71	actor bob hoskins dies at 71
venezuela 's maduro pledges continued alliance with cuba	venezuela 's maduro pledges continued alliance with cuba
obama sweats over sweaters during ny shopping stop	us president sweats over sweaters during ny shopping stop
stocks rise after summers exits fed race	stocks , bonds rally after summers exits fed race
trayvon could have been me	trayvon martin could have been ...
python kills security guard near bali luxury hotel	python kills security guard in bali
obama to meet s 'korean leader	obama to meet south korean leader
russia warns it will respond if interests attacked in ukraine	russia warns it will ' respond ' if interests in ukraine attacked
renowned spanish flamenco guitarist paco de lucia dies	spanish flamenco guitarist paco de lucia dies at 66
belgian king albert ii to step down in favor of son	belgian king albert ii to abdicate in favor of his son
suicide truck bomber kills 11 in northern iraq	suicide bomber kills 15 in northern iraq
suicide bomber kills 15 in central somalia	suicide bomber kills 13 at restaurant in central somalia
hundreds evacuated as indonesia volcano erupts	hundreds evacuated as sumatran volcano erupts
latest storm brings more snow to us east coast	latest storm to bring more snow to east coast
aid gets to philippines typhoon survivors	aid pushes through to philippine typhoon survivors
ntu drops to 82nd in world university rankings	ntu slips in world university rankings
buddhist mob attacks mosque in sri lanka , 7 injured	buddhist mob attacks mosque in sri lanka 's capital
machete-wielding student aimed for carnage	machete-wielding student aimed for mass carnage in colorado
bangladesh building death toll tops 500	bangladesh building disaster death toll passes 500
man sets himself on fire on the national mall	man set on fire on national mall
hosni mubarak retrial adjourned until 8 june	mubarak retrial adjourned to june
us drone strike kills eight in waziristan	us drone strike kills 11 in pakistan
australia leader ousted in snap leadership vote	australian pm gillard ousted in leadership vote
manila charges chinese on reef crash	manila charges china fishermen over reef crash
israel carries out routine missile test in mediterranean	israel says it conducted missile tests in mediterranean
boston marathon bombing suspect buried in virginia	boston bombing suspect buried in virginia cemetery
bangladesh court sentences 152 border guards to death over 2009 mutiny	bangladesh court sentences 152 soldiers to death in mutiny
protesters gather in brazil despite concessions	protests sweep brazil despite concession
egypt protesters defy cabinet threat to end sit-ins	egypt protesters defy cabinet threat
'fast & amp ; furious ' star paul walker dies in car crash at 40	'fast & amp ; furious ' star dies in car crash
car bombs kill 20 in turkish town near syrian border	car bombs kill four in turkish town on syrian border
oscar-winning actor philip seymour hoffman found dead	actor philip seymour hoffman found dead
turkey could deploy army to quell protests	turkey may deploy army to end protests
dame vivienne westwood joins fracking protesters	vivienne westwood joins balcombe fracking protest
sen . mark kirk announces support for same-sex marriage	gop sen . kirk announces support for gay marriage
couple marry in the uk 's first scientology wedding	couple get married in britain 's first scientology wedding
china launches longest-ever manned space mission	shenzhou-10 capsule : china launches 15-day manned space mission
uk has ' paid a very high price ' in afghanistan , says david cameron	pm : uk has ' paid a very high price ' in afghanistan
russian opposition leader under house arrest	russian opposition leader placed under house arrest
two explosions at boston marathon	two explosions at boston marathon finish line
senate confirms janet yellen as chair of us federal reserve	senate confirms janet yellen as next federal reserve chair
syria opposition agrees to talks	syrian opposition agrees to geneva peace talks
clegg and farage are both ' quite extreme ' over europe , says cameron	clegg and farage are extremists on europe , says cameron
asiana airlines boeing 777 crashes on landing at san francisco airport	boeing 777 crashes while landing at san francisco airport
sweden court upholds arrest warrant for wikileaks founder julian assange	swedish court upholds arrest warrant for julian assange
uganda 's president signs anti-gay bill	uganda 's president to sign anti-homosexuality bill
qatar 's emir hands power to his son	qatari emir hands power to son tamim
carlo ancelotti named real madrid boss	ancelotti named real madrid coach
easing of concerns over syria boosts global stocks	easing of concerns over syria boost asian shares
philippines typhoon death toll feared to hit 7,000	philippines typhoon death toll rises above 5,000
egypt braces for ' friday of anger ' after carnage	egypt braces for friday of anger after bloody crackdown
divers find human remains on site of italy cruise ship wreck	divers find human remains near italian shipwreck
nelson mandela leaves hospital after 10 days	mandela leaves hospital after 10 days
mobile home fire kills man , 5 kids in ohio	police : ohio mobile home fire kills man , 5 kids
japanese politician arrested in china on drug charges	japanese politician arrested in china for transporting drugs
new york train derailment kills four , injures 70	new york train crash kills four , injures dozens
red sox beat tigers 5-2 to advance to world series	red sox beat tigers to reach world series
african nations press u.n. security council to suspend kenya case	african nations press un council to suspend kenya case
microsoft announces 18,000 job cuts in reorganization	microsoft to cut 18,000 jobs in major reorganization
more than 1,000 inmates escape libyan prison	more than 1,000 inmates escape from libya 's al-kweifiya prison
dutch couple kidnapped in yemen appeals for release	dutch couple kidnapped in yemen plead for help in video
china lands jade rabbit robot rover on moon	china lands robot rover on moon
malaysia airlines plane ' shot down ' in ukraine	malaysian plane shot down over ukraine
philippines welcomes its 100 millionth citizen	philippines welcomes 100millionth baby
us embassy in israel celebrates fourth of july	us embassy in israel marks 4th of july
microsoft ceo ballmer to retire in a year	microsoft ceo ballmer to retire within 12 months
protesters celebrate in istanbul square	protesters celebrate after police leave istanbul square
37 missing , two dead after boat sinks off malaysia	dozens missing after boat sinks off malaysia
obama lashes north korea as pariah state	obama lashes north korea as weak pariah state
manning says he is female , wants to live as a woman	bradley manning says he wants to live as a woman
libya 's former prosecutor general shot dead	libya 's first post-uprising prosecutor general shot dead
more french soldiers to central african republic	france to send more soldiers to central african republic
hagel says u.s. still seeks ' international coalition on syria	us to seek international coalition on syria
phil mickelson wins british open with superb final round	phil mickelson wins the open championship with superb final-round 66
bangladesh garment factory owners surrender to court over homicide charges	bangladesh garment factory owners surrender over deadly fire
james gandolfini dies aged 51	sopranos star james gandolfini dies aged 51
bangladesh collapse death toll passes 620	bangladesh building death toll passes 600
petkovic , halep into french open semis	petkovic , halep reach french open semifinals
ukrainian parliament dismisses president	ukraine 's parliament votes to dismiss president
venezuela lawmakers brawl amid election tensions	venezuela lawmakers brawl over election
cyclone leaves trail of destruction in india	cyclone phailin leaves trail of destruction
hezbollah leader vows to continue syria fight	hezbollah leader vows to fight on in syria
israel pm says ground offensive in gaza under way	israel starts ground offensive in gaza
imf approves $ 17 billion loan for ukraine	imf approves 17 billion usd aid package for ukraine
north korea warns foreigners in south , advising evacuation	north korea warns foreigners in south to evacuate
abortion vote delayed amid debate irish politicians will spend a second day debating divisive laws that will legislate for the first time for abortion in limited circumstances .	abortion bill : second night of debating in the dail new irish politicians have begun a second night of debating divisive laws that will legislate for the first time for abortion in limited circumstanc
israel hits back after rockets fired from lebanon	israel retaliates after multiple rockets fired from lebanon
captain of sunken south korean ferry arrested	captain of capsized s korean ferry arrested
four dead in navy yard shooting	at least 6 dead in navy yard shooting
everest avalanche kills six sherpas	everest avalanche kills 12 guides
sectarian clashes in northern lebanese city kill 8	lebanon : sectarian clashes in northern city kill 9
taliban chief killed in pakistan drone strike	pakistani taliban chief killed in drone strike
berlusconi expelled from italian senate	silvio berlusconi expelled from parliament
obama to tap charlotte mayor to run transportation	obama taps foxx - nc mayor - to run transportation
ferry sinks in collision in philippines ; 24 dead	ship sinks after collision off philippines ; 24 dead
divided syria opposition debates joining peace talks	syria opposition votes to join peace talks
daughter says mick jagger to be great-grandfather	sir mick jagger ' to become great-grandfather'
interpol issues arrest notice for ' white widow'	samantha lewthwaite : interpol issues global arrest warrant for white widow
u.s. woman pleads guilty to killing 2 ontario tourists	philadelphia woman pleads guilty to killing 2 canadian tourists
obamas to attend mandela memorial in johannesburg	obama to attend memorial service in johannesburg
pakistan freeing 7 more taliban prisoners	pakistan releases seven taliban prisoners
california wildfire spreads into yosemite national park	fast-moving wildfire spreads to yosemite national national park
north korea releases australian missionary	north korea says it will deport australian missionary
cars , drivers plunge into river after wash . i-5 bridge collapse	cars plunge into river as us bridge collapses
nfl seeks $ 1.5m from m.i.a. over super bowl finger	nfl seeks us $ 1.5m over super bowl finger
4 saudis held over tanzania bombing	saudis held over tanzania attack
obama canceled meeting with putin	obama cancels meetings with putin amid tensions
israel confirms strike on syria targeted weapons	israel officials : strike on syria targeted weapons
west indies too good for bangladesh	twenty20 world cup : west indies rout bangladesh
'trayvon could have been me'	trayvon martin could have been ...
minimum alcohol pricing would save 860 lives a year , study finds	minimum alcohol pricing ' will save 860 lives a year ' , experts claim
iran 's president-elect calls israel a ' wound ' on muslim world	iran 's president-elect calls israel a ' wound'
margaret thatcher dies of stroke aged 87	margaret thatcher dead after stroke
death toll in syria now tops 100,000	death toll in syria over 100,000 so far
firefighters perish in arizona blaza	19 firefighters killed in arizona blaze
france deports tunisian accused of jihadist recruitment for syria	france deports tunisian suspected of recruiting jihadists for syria
two members of pussy riot punk band arrested in sochi	2 pussy riot band arrested in sochi
adele named richest young musician	adele named richest young musician with £ 45 million
tropical storm andrea approaches fla . ' s gulf coast	tropical storm andrea drenches florida 's west coast
un invites iran to syria peace talks	un withdraws iran 's invite to syria peace talks
afghan president delays signing deal with us	afghan president delays signing us deal
strong new quake hits shattered pak region	powerful new earthquake hits shattered pakistan region
drone strike kills al-shabab militant in somalia	us strike kills 2 senior al-shabaab militants in somalia
amazon 's bezos rescued by ecuadorian navy	amazon 's bezos rescued by ecuador navy due to kidney stone
captain of sunken south korean ferry arrested	captain , crew of south korean ferry that sank arrested
germany crushes brazil in world cup semifinal	germany crush brazil 7-1 to reach world cup final
communist rebels ambush philippine police , kill 7	communist rebels kill eight philippine police
egypt 's morsi faces trial for prison break , murder , says prosecution	egypt 's morsi faces trial for prison break
iran nuclear talks enter third day	iran nuclear talks enter crucial third day
at least 22 dead after china earthquake	at least 89 dead in china earthquakes
jurors find jodi arias eligible for death penalty	jodi arias eligible for death penalty , jury says
us urges north korea to release detainee	u.s. urges north korea to release 85-year-old war veteran
turkish riot police move into taksim square - live updates	turkish riot police enter taksim square
bolshoi ballet chief confronts alleged attacker in court	bolshoi director sergei filin confronts alleged acid attacker in court
asiana jet crash lands at san francisco airport	deadly plane crashes at san francisco airport
legendary author maya angelou dies at age 86	maya angelou dies at age 86
hollande ' threatens legal action ' after affair allegations	françois hollande threatens legal action over affair claims
hong kong set for huge democracy rally on handover anniversary	hong kong set for huge democracy rally
egypt 's hosni mubarak to be freed soon	egypt 's hosni mubarak released from prison
british actor bob hoskins dies at 71	actor bob hoskins dead at 71
un syria inspectors head to alleged chemical attack site	un inspectors visit alleged chemical attack site
thai army declares martial law	thailand 's army declares martial law , denies coup
demolition work begins on don valley stadium	demolition work to begin at stadium
two dead after boeing 777 crash lands at san francisco airport	plane crash lands at san francisco airport
stocks higher at midday as black friday unfolds	stocks end mixed as black friday unfolds
blast in pakistani city of peshawar kills 14	blast in pakistani city of quetta kills at least 20
nibali seals tour de france win	nibali set for tour de france glory
woman dies while riding roller coaster in texas	woman dies riding roller coaster at texas amusement park
scottish oil worker shot dead in brazil	british oil worker killed in brazil
jos . a . bank buys eddie bauer	jos . a . bank buying eddie bauer in $ 825m deal
brazil boss luiz felipe scolari backs england to impress at 2014 world cup	scolari backs england to impress at world cup
nobel author doris lessing dies at 94	nobel prize winning author doris lessing dies
british woman dies on cross-channel charity swim	woman dies in channel charity swim
31 dead , 90 injured in china marketplace bombing	dozens killed in china marketplace bombing
over 100 dead as typhoon slams central philippines	at least 100 dead as typhoon batters philippines
siemens boss to asked to leave firm after poor results	siemens boss peter loescher to go after poor results
rafael nadal beats novak djokovic to win ninth french open title	french open live : rafael nadal beats novak djokovic in final
first post office savings bank atm opens in chennai	india 's first post office savings bank atm inaugurated in chennai
israel agrees to 12 hour ceasefire	israel agrees to 24-hour gaza truce
twitter reports blocking in venezuela	twitter says images blocked in venezuela
gop sen . mark kirk backs same-sex marriage	sen . mark kirk announces support for same-sex marriage
fast-moving new mexico blaze causes evacuations	fast-moving new mexico blaze causes ...
quake of 6.2 magnitude strikes off indonesia 's sumatra - usgs	earthquake of 6.9 magnitude strikes off indonesia island
kerry says doubling u.s. non-lethal aid to syrian opposition	us committed to providing non-lethal aid to syria opposition
egypt 's mubarak to be freed from jail , lawyer says	hosni mubarak to be freed within days , lawyer says
g7 leaders to ' move swiftly ' to impose new sanctions against russia	g7 leaders agree on new sanctions against russia
syrian opposition wants rebel backing for geneva talks	syrian opposition seeks rebels ' blessing to enter peace talks
us supreme court limits president 's recess appointments power	high court checks president 's recess appointment power
strongman sisi sworn in as egypts president	abdel fattah al-sisi sworn in as egypt president
three held over dissident republican activity	three arrested in dissident republican inquiry
obama praises mandela ' inspiration'	obama hails mandela 's inspiration effect
china airs confession by detained blogger amid online rumor crackdown	china airs confession by detained blogger
three women missing for a decade found alive in cleveland home	three women , missing for years , found in us home
british stuntman fell to his death in wing suit mishap	british stuntman dies in wingsuit mishap in alps
nazi war criminal dies at 100	nazi war criminal dies
rolf harris faces three more assault charges	harris faces three new sex assault charges
one dead , eight missing after ships collide off japan	eight missing after ships collide
deutsche telekom profit up , sees rebound in us	deutsche telekom profit up , cuts outlook
thailand trains to south halted by suspected bomb	south trains halted by suspected bomb
yakuza loans scandal claims second lender	japan mob loans scandal claims another lender
euro crisis is over , says france 's francois hollande	eurozone debt crisis is over , says france 's president
what makes india vote ? jaipur lit fest debates	what makes india vote ? debate at jaipur literature festival
cyclone phailin leaves trail of destruction , cyclone intensity weakens	cyclone phailin kills 14 , leaves trail of destruction in india
golden dawn chief remanded in custody pending trial	golden dawn leader remanded in custody
'de-americanised world needed after us shutdown'	'de-americanized ' world needed after u.s. shutdown , says china media
signals from missing malaysia airlines plane located in vietnam	missing malaysia airlines plane ' crashes off vietnam'
french troops pour into central african republic	french troop deployment lessens violence in central african republic
four kenyans injured in south sudan clashes	'hundreds dead ' in south sudan clashes
pistorius neighbour ' heard screams'	pistorius neighbour woke to ' terrible screams'
powerful blast causes injuries in prague	powerful blast injures up to 40 in prague
deal reached on iran nuclear program	interim deal struck on iran 's nuclear program
microsoft to cut 18,000 jobs in overhaul	microsoft to cut 18,000 jobs in cost plan
iran needs more nuclear power plants	iran to build 2nd nuclear power plant
canadian actor august schellenberg dies in dallas	mohawk actor august schellenberg dies at 77
french soldier stabbed in the neck in paris	french soldier stabbed on patrol in paris
white diamond breaks record in hong kong auction	white diamond fetches record $ 34m at hk auction
saudi arabia declines united nations security council seat	saudi arabia rejects seat on un security council
iraqi car bomb near church kills at least 14	car bomb near iraq church kills at least 14
italy 's letta names new government	italy finally forms new government
israel agrees to temporary gaza humanitarian truce	israel , hamas agree to gaza ' humanitarian ' pause
chinese satellite spots large object in search area	malaysia : chinese satellite found object in ocean
three-year-old child among injured in chicago shooting	three-year-old child in critical condition after 11 are injured in chicago park shooting
standard chartered h1 net profit down 24 %	standard chartered profit sags
clashes in istanbul extend into night in taksim	clashes in turkey extend into night
code red sirens heard in hof ashkelon regional council	media : 2 rockets explode in hof ashkelon regional council
dutch experts headed to mh17 crash site	dutch team heads for mh17 crash site
us-born rossi left off italy 's world cup squad	rossi absent from italy world cup squad
goa building collapse death toll touches 15	indian building collapse deaths rise to 14
landmark rwanda genocide trial opens in france	rwanda genocide trial opens in paris , french first
russell whirlwind century stuns tigers and sets up hpc win	russell whirlwind century stuns tigers
death toll hits 238 in bangladeshi building collapse	death toll in bangladesh building collapse rises to 164
pak religious body endorses underage marriage	cii endorses underage marriage
building collapse in philadelphia injures at least 12	building collapses in philadelphia , 14 pulled from rubble
jpmorgan to pay $ 1.7 billion to settle madoff case	jpmorgan to pay over $ 2.5 billion in madoff fraud
nineteen wounded in shootings at mother 's day parade in new orleans	nineteen hurt in mother 's day shooting in new orleans
4 french journalists freed after 10 months in syria	four french journalists freed 10 months after being kidnapped in syria
treasury proposal sees 1.5 % increase in income tax	treasury proposes 1.5 % income tax raise in budget
russian opposition leader navalny detained briefly in moscow	russian opposition leader navalny briefly detained
blast at japan chemical plant kills 5 , injures 17	blast at japan chemical plant , 5 killed
a us hijacker returns from cuba	us hijacker returns home from cuba after 30 years
holland loses triple-a credit rating	netherlands loses s & p triple-a credit rating
strong new quake hits shattered pak region	6.8 quake in shattered pakistan region
pawar sparks row with ' bogus voting ' remark	pawar sparks row with ' bogus voting ' remark , plays down it
malaysia airlines flight shot down in eastern ukraine	malaysian plane shot down over ukraine
pakistan pm in kabul to discuss peace talks	pakistan pm heads to kabul to push peace efforts
eu ministers of employment and social policy will discuss how to boost employment , integrate social and economic policies	eu ministers of employment and social policy to discuss employment boosting strategies
u.n. security council calls for humanitarian ceasefire in gaza	gaza crisis un security council calls for unconditional ceasefire
shenzhen market fire kills 15	china market inferno kills 15
bodies of beheaded fishermen found on boat	bodies of eight beheaded fishermen found on boat in philippines
u.s. extends some embassy closures over qaida threat	u.s. extends embassy closures due to ' serious threat'
astrazeneca rejects ' final ' pfizer offer	astrazeneca board rejects new pfizer offer
putin soon to pardon tycoon khodorkovsky	putin signs pardon for mikhail khodorkovsky
riot police disperse protesters in istanbul park	turkish police launch assault on protesters in istanbul park
north korea launches short-range missiles	north korea fires short-range missiles into sea of japan
madagascar 's presidential results trickle in	madagascar presidential election kicks off
soldiers take part in fire drill in ne china	forest team tackles fire drill in ne china
anti-hezbollah protester shot dead in beirut	anti-hezbollah protester killed in lebanon
ukraine doesn 't respond to russian ' provocation'	ukraine refuses to act against russian ' provocation'
hawaii senate passes gay marriage	hawaii passes gay marriage bill
south sudan government , rebels set for new year 's day talks	ethiopia : south sudan government , rebels to hold talks
hamas urges hizbullah to pull fighters out of syria	hamas calls on hezbollah to pull forces out of syria
hezbollah commander killed outside beirut home	hezbollah chief killed in beirut
starbucks pays first uk corporation tax since 2009	starbucks starts paying uk corporation tax
controversial cop who pepper-sprayed seated students during ows protest seeks workers compensation for psychiatric injury	cop who pepper-sprayed students seeks workers comp , claims psychiatric injury
philip seymour hoffman found dead with needle in arm	us actor philip seymour hoffman found dead in new york
turkish court ruling would block disputed park project	turkish court cancels disputed istanbul park project
5 key lao officials killed in plane crash	laos defence chief killed in plane crash
helicopter crashes into roof of glasgow club	helicopter crash in glasgow , scotland
russia 's channel one journalist killed in ukraine 's donetsk	russian journalist killed in ukraine
afghans tally votes in landmark presidential runoff election	afghans vote in presidential runoff
flash floods kill 58 in eastern afghanistan	bomb wounds 16 in eastern afghanistan
turnout low , egypt extends presidential vote a day	egypt extends presidential election voting 1 day
u.s. and russia reach a deal on syria 's chemical weapons	china welcomes us , russia deal on syria chemical weapons
egypt regime hails passage of new constituion	egyptians ' say yes ' to new constitution
four jailed for killing roma in spree that shocked hungary	four jailed for neo-nazi killing spree that terrified hungary 's roma
cambodian opposition retracts claim of election win	cambodian strongman pm 's party claims election win
twitter prices ipo at $ 26 per share , raising $ 1.82b	twitter prices i.p.o. at $ 26 a share
psni failed ruc officers , tribunal told	13 : 23 psni ' failed ruc officer families'
10 injured in san francisco plane crash	obama hails responders at san francisco plane crash
stocks edge lower following retail earnings	stocks edge lower after earnings from retailers
belgian king albert ii to abdicate in favor of his son	belgium king albert ii ' to abdicate'
iranian rial climbs 10 percent as hopes grow over new president	iranian rial climbs 10 percent after new president elected
pistorius pleads ' not guilty ' at start of murder trial	pistorius pleads not guilty to murder as trial starts
police helicopter crashes into scottish pub	police helicopter crashes on top of bar in glasgow
malaysian plane 's pilots under scrutiny	plane 's pilots under scrutiny in mystery
boston bombing suspect captured	boston bombing suspect reported cornered on boat
german chancellor angela merkel reduces appointments after skiing accident	german chancellor angela merkel injured in ski accident in switzerland
u.s. , chinese warships nearly collide in south china sea	chinese and american ships nearly collide in south china sea
soldier stabbed in paris	french soldier stabbed on patrol in paris
4 french journalists freed after 10 months in syria	4 french journalists held hostage in syria freed
us-russia reach agreement on syria weapons	us , russia closer to agreement on syrian chemical weapons
first book printed in america sells for record $ 14.2 million	first book printed in the us sells for $ 14.2 million at sotheby 's auction
white house statement on crimean referendum	duma faction leaders to submit statement on crimean referendum
us ups pressure on israel as un demands gaza truce	us , un up pressure on israel over gaza
australian government sticks to huawei ban	new australia government upholds ban on huawei
un chief boots iran out of syria peace talks	un chief withdraws invitation for iran to join syria peace talks
anthony weiner 's campaign manager quits	anthony weiner 's campaign manager calls it quits , report claims
tornado hits oklahoma city suburb	deadly tornado hits oklahoma city suburb , at least 37 dead
daughter and son-in-law of elderly couple found buried in their back garden are charged with murder	daughter and son-in-law accused of murdering elderly couple found buried in back garden after vanishing 15 years ago are remanded in custody
sisi sworn in as egypt 's president	egypt 's sisi sworn in as president
japanese planes flew into china 's new defense zone	japan , s korean military planes defy china 's new defence zone
russia drops charges against 29 greenpeace crew	russia drops charges vs 16 greenpeace activists
taliban militants storm pakistan prison , freeing hundreds of ' dangerous terrorists'	taliban gunmen storm pakistan prison , free hundreds
brazil military rule torturer dead	brazilian military ruler paulo malhaes dead
israel accuses syria of using chemical weapons	israel : syria using chem weapons
yale uni in lockdown after gunman sighted	yale university in lockdown amid gunman alert
'23 % have lost track of pension'	workers ' losing track of pensions'
australian pm says ' very confident ' signals are from black box	australian pm confident sounds are from flight 370
syrian opposition awaits invitation to geneva peace talks	syrian opposition seeks rebels ' blessing to enter peace talks
us issues travel alert over al qaeda threat	us issues global travel alert , cites al-qaida threat
nobel author doris lessing dies at 94	british nobel-winning author doris lessing dies
mt gox reveals 200,000 ' forgotten ' bitcoin haul	mt gox finds 200,000 ' forgotten ' bitcoins
deadly clashes as egypt marks anniversary	deadly violence marks egypt revolt anniversary
mandela 's condition has ' improved'	mandela 's condition has ' worsened over past 48 hours'
new york funeral planned for conn. woman killed in capitol car chase	ny funeral held for woman killed in dc car chase
chinese lunar rover lands on moon	china lands robot rover on moon
florida us rep . bill young dies at 82	florida congressman young dies at 82
eurozone unemployment heading for 20 million	eurozone unemployment at new record
cypriot finance minister michalis sarris resigns	cyprus finance minister resigns
guests found dead in swimming pool at luxury hotel had drowned	couple found dead in swimming pool both drowned , tests reveal
4 injured in blast near egypt 's sharqiya military intelligence hq	4 officers injured in attack on egyptian military intelligence offices
death toll rises in pakistan church suicide bombing	death toll in pakistan church bombing rises to 81
earthquake of 6.9 magnitude strikes off indonesia island	earthquake hits near indonesia islands
senate moves forward on immigration bill	u.s. senate backs border amendment to immigration bill
fox news anchor charged after airport arrest	fox news anchor freed after arrest for belligerence at airport
boy , 14 , arrested for sex attacks around a university campus	two teenagers arrested after string of sex attacks on manchester university campus
philippe becomes king of belgium	philippe ascends throne of divided belgium
australian spirits high says clarke	australian spirits are high aft ...
3 chinese tourists killed in pakistan	gunmen kill nine tourists in pakistan
duchess of cambridge and royal baby ' doing well'	duchess of cambridge gives birth to baby boy
two planes nearly collide at central vietnam airport	planes in ' near miss ' at vietnam airport
israelis , palestinians kick off peace talks	israelis , palestinians set for talks on home turf
welsh councils ' largely unprepared ' for scale of budget cuts	councils ' unprepared ' for deep cuts
india anti-graft party takes charge in new delhi	india 's anti-graft party forms government in delhi
spain approves new restrictive abortion law	spanish government approves tight restrictions on abortion
bangladesh to allow unions for garment workers	bangladesh factory collapse survivor gives up garment work
cleveland kidnapper ariel castro dead in jail cell	cleveland kidnapper castro commits suicide in prison cell
teen survives five-hour flight to hawaii ' in airplane wheel well'	teen stowaway ' traveled to hawaii on plane wheel well'
carphone warehouse and dixons confirm all-share ' merger of equals'	carphone warehouse and dixons reveal £ 3.8bn merger
plane debris may have sunk	mh370 search draws blank , debris may have sunk
spain opposition demands prime minister resign	spain 's opposition leaders call on rajoy to resign
four arrested as bangladesh building toll rises to 352	2 arrested as dhaka building collapse toll reaches 332
government approves prisoners ' release	israel cabinet approves palestinian prisoner release
obama orders syria ' gas attack ' inquiry	un urges syria gas attack inspection
two u.s. astronauts set to make christmas eve spacewalk for repair job	astronauts make rare christmas eve spacewalk
microsoft says to cut up to 18,000 jobs	microsoft to lay off 18,000
rf urges its partners to denounce kiev authorities ' actions in ukraine 's southeast	putin : russia expects un to denounce kiev authorities ' anti-constitutional actions
'dozens injured ' after texas fertiliser plant explosion	hundreds believed injured in texas fertiliser plant blast
angkor wat gets google 's street view	cambodia 's angkor temples added to google 's street view
mandela responding to treatment , says south africa 's zuma	zuma : mandela ' responding better to treatment'
former-fm lieberman acquitted of allegations	israel 's former fm lieberman acquitted in fraud trial
dolce and gabbana fined in italian tax case	dolce and gabbana sentenced to jail for tax evasion
dozens still missing after canada train blaze	40 still missing in deadly canada oil train crash
two confirmed dead after passenger jet crashes in san francisco	2 die and many are hurt as plane crashes in san francisco
nato soldier killed in afghan attack	nato soldier killed in taliban attack in afghanistan
microsoft ceo ballmer to retire within 12 months	at a glance : microsoft ceo ballmer 's ups and downs
explosion hits fertilizer plant in texas	deadly explosion at texas fertiliser plant
17 wounded in shooting at new orleans parade	17 hurt at new orleans parade shooting
democrat de blasio takes big apple	democrat de blasio elected nyc mayor
egypt 's interior minister survives an assassination bid	egypt 's interior minister survives bomb attack
world powers , iran clinch ' historic ' nuclear deal	iran , six world powers clinch breakthrough nuclear deal
german ambassador 's athens residence shot at	shots fired at german ambassador 's residence in athens
unmanned russian rocket crashes after launch in kazakhstan	russian rocket explodes in kazakhstan
diana nyad completes record swim on fifth try	'never , ever give up ' : diana nyad completes historic cuba-to-florida swim
us government shutdown begins - live updates	government shutdown begins over health care feud
afghanistan praised for historic elections	afghanistan enjoys peaceful presidential elections
kenya minister says 59 killed in mall attack	two indians among 39 killed in kenya mall attack
two slovaks killed in kabul suicide car bomb	3 coalition soldiers killed in kabul car bombing
palestinians celebrate prisoner release	palestinian president greets released prisoners
ukraine 's jailed opposition icon tymoshenko walks free	ukraine 's opposition chief wants more protests
diplomats gather to plan syria peace conference	envoy : new june 25 meeting to prepare syria peace conference
powerful earthquake hits off chile , triggers tsunami	powerful quake hits chile
oklahoma examines what went wrong in botched execution	okla. inmate dies of heart attack after botched execution
snowboarder buried alive after ice tunnel on mount hood collapses as he was passing through it	snowboarder buried when tunnel on ore. mountain collapses ; search resuming at dawn
napolitano elected for second term as italy president	italian president napolitano elected for second term
two killed in chile forest fire	eleven killed in forest fire in chile
us scientists awarded nobel prize for chemistry for work on computer modelling	nobel prize for chemistry goes to computer whiz trio
more than 100 injured in texas plant blast	hundreds believed injured in texas fertiliser plant blast
bale scores on debut as real madrid draw at villarreal	bale scores on debut ; villarreal holds madrid
un court convicts 6 bosnian croats of atrocities	un war crimes court convicts six bosnians croats
u.s. accuses russia of sending tanks into eastern ukraine	russia sent tanks against ukraine
toronto rapper drake gets 4 grammy nominations	snubs , surprises in grammy nominations
israel to free palestinian prisoners over kerry talks	middle east peace talks : israel promises release of palestinian political prisoners after john kerry discussions
south korea to tax cosmetic surgery jobs , religious figures	south korea looks to plastic surgery for new taxes
putin challenges us on syria claims	putin demands us prove syria chemical arms use
mixed reactions to nz same-sex marriage	new zealand legalizes same-sex marriage
government approves prisoners ' release	yacimovich urges cabinet to approve palestinian prisoners release
israel to free palestinian prisoners as deal to resume peace talks emerges	channel 2 : israel to free around 100 prisoners after talks resume
fire destroys ancient tibetan town in china	ancient tibetan town in china destroyed by fire
at least 95 dead as egypt declares state of emergency	egypt declares month-long state of emergency
hm king hamad receives hindu baps delegation	hm king hamad receives gcc audit courts presidents
eu foreign ministers to discuss syria arms embargo	austria : eu fails to reach deal on syria arms embargo
pro-russian mob attacks prosecutor office in ukraine 's donetsk	pro-russians protesters storm donetsk prosecutor 's office in eastern ukraine
egypt minister survives assassination attempt	egypt 's interior minister survives bomb attack
scores killed in iraq attacks	scores killed in baghdad car bombings
shingles vaccine for the elderly	shingles vaccine campaign to start
un gunships strike ugandan muslim rebels in dr congo	un choppers strike at ugandan rebels
russia raises alarm over israeli missile test in mediterranean	israel says it carried out joint missile test with us in mediterranean
u.s. warns north korea against missile launch	u.s. tells north korea new missile launch would be " huge mistake "
dave lee travis pleads not guilty to all charges	dj dave lee travis denies 15 sex charges
scientists hope comet-chaser spacecraft wakes up	rosetta comet-chasing spacecraft wakes up
saudi man with pressure cooker arrested at detroit airport	saudi man traveling with pressure cooker arrested
breaking : comic actor mel smith dies of heart attack aged 60	15 : 08 ' comedy great ' mel smith dies at 60
twitter unveils its ipo filing	twitter unveils ipo filing , aims to raise $ 1 billion
chidambaram questions imf 's growth projection	chidambaram questions imf 's methodology for calculating india 's growth projections
co-op bank boss quits amid moody 's downgrade	co-op defends banking business after moody 's downgrade
putin calls for troops to be sent to ukraine	britain calls for de-escalation of tensions in ukraine
u.s. stocks inch up after encouraging jobs reports	us stock futures edge up ahead of jobs report
myleene klass makes dec philippines appeal	un launches philippines aid appeal
astrazeneca pays $ 4.1bn to buy bristol-myers squibb out of diabetes alliance	astrazeneca to buy bristol out of diabetes venture for up to $ 4.1 billion
world mourns south africa peace icon mandela	zuma heralds ' our icon ' on south africa 's day of prayer for mandela
search for pilot of ny angel flight resumes	rescuers look for pilot in deadly ny angel flight
bangladesh sentences 152 to death for 2009 mutiny	death sentence for 152 soldiers over mutiny
rousseff says brazil can do better	rousseff set to address brazil protests
mandela not ' vegetative ' - govt	doctors deny mandela in ' vegetative state'
sinaloa drug chief captured in mexico	mexico 's sinaloa drug chief arrested
britain rules out military action in syria	uk parliament blocks british military action against syria
matt smith quits bbc 's doctor who	matt smith leaving lead role in bbc 's ' doctor who'
23 : 21 us senate to vote on gun checks	senate may vote on gun reform wednesday
car bomb explodes in beirut 's hezbollah stronghold	strong explosion hits hizballah stronghold in beirut
russian protest leader denounces ' political ' trial	russian protest leader says trial is putin 's revenge
arab idol winner given hero 's welcome in gaza	palestinians welcome arab idol winner coming home in gaza
gunfire rocks dr congo capital	heavy gunfire reported at airport in dr congo capital
north korea says to put us citizen on trial	north korea says detained american tourist to face trial
at least 239 people feared dead as malaysian airlines jet vanishes off vietnam	last picture of couple feared dead after malaysian airlines flight ' disappears ' in south china sea
two hundred missing in philippines ferry disaster	at least 32 dead , 170 missing in ferry disaster
anti-china protests spread across vietnam	more than 20 dead as anti-china riots spread in vietnam
three possible motives behind israel 's recent airstrike on syria	iran condemns alleged israeli airstrike on syria
microsoft says to cut up to 18,000 jobs	microsoft to cut 18,000 jobs in cost plan
nidal hasan guilty in 2009 fort hood shooting rampage	nidal hasan found guilty of killing 13 at fort hood base
ftc accuses t-mobile of charging its customers for fraudulent cell phone spam	ftc accuses t-mobile of knowingly billing customers for hundreds of millions in bogus charges
jury deliberates as dana brother accused of sex abuse	court clears dana 's brother of all counts of historic sex abuse
obama ' heartbroken ' at another fort hood shooting	fatalities reported in fort hood shooting
syria agrees to un probe into chemical attack	syria allows un visit to chemical attack site
afghan taliban attack near kabul airport	insurgents battle afghan forces near kabul airport
boeing jumbo jet plane lands at wrong airport	boeing 747 jumbo jet stuck after mistakenly landing at tiny kansas airport
death toll rises to 13 in goa building collapse	rescuers search for survivors after 15 die in india building collapse
additional aid approved for texas fertilizer plant blast	fema oks aid for texas plant blast
thai protests escalate amid violence	thai protesters call general strike
indian pm singh to step down after 2014 elections	indian pm to step down
three survive us-canada bridge collapse	cars plunge into river as us bridge collapses
gunmen in nairobi launch attack on mall , kill 30	gunmen storm nairobi mall , 15 killed
death toll from typhoon rammasun rises to 17 in china	typhoon rammasun death toll hits 33 in china
3 suspects taken into custody in boston bombing case	boston police say 3 taken into custody in marathon bombing
egypt imposes state of emergency after 95 people killed	egypt announces one-month state of emergency nationwide
giant wildfire threatens yosemite park	raging , fast-moving california wildfire threatens yosemite national park
tokyo stocks close 0.49pc lower	tokyo stocks open lower on gains lock
kerry looks to china to defuse korea tensions	kerry in japan amid n korea tensions
all set for national economic forum tuesday	nduom hopeful in outcome of national economic forum
white south africans ' uneasy love affair with mandela	south africa prepares funeral for the ages for mandela
taiwan politicians scuffle over nuclear bill	meltdown in taiwan parliament over nuclear poll
snowden , us intelligence whistleblower , nominated for nobel peace prize	snowden nominated for nobel prize
obama to press china on cybersecurity	obama urged to prod china on human rights
cable warns on help to buy ' bubble'	vince cable worried by help to buy home ownership bubble
facebook pulls beheading video	facebook removes beheading video , reopens debate
connecticut adopts strictest gun control laws in us	connecticut passes stringent gun controls in response to sandy hook massacre
un to hold emergency dr congo talks	un security council holds emergency meeting over dr congo fighting
deadly explosions hit boston marathon in us	report of two explosions at finish line of boston marathon
taliban video shows handover of us soldier	taliban release video of us soldier 's handover
egypt 's new consitution explained	egypt 's second try at new constitution ' an improvement'
obama to visit robben island in mandela tribute	obama visits mandela 's robben island cell
israel launches ground operation in gaza	israeli military starts ground offensive in gaza
78 killed in pak church bombing	deaths in pakistan church bombing rise to 43
malaysians vote in polls for stability or change	malaysia elections : malaysians vote with power at stake for first time
kerry in egypt on first visit since morsi ouster	kerry in first trip to egypt since ouster of mursi
prince george christened by archbishop in london	prince george 's christening under way
philippines readies for mass burials	typhoon-struck philippine city begins mass burial
rallies demand ' justice for trayvon'	across us , people rally for ' justice for trayvon'
1000 estimated dead after typhoon rips through philippines	over 100 dead as typhoon slams central philippines
sir jon cunliffe to join bank of engalnd as deputy governor	bank of england names cunliffe as deputy governor
mighty mickelson wins open at last	us golfer phil mickelson wins the open
death penalty for heroin traffickers in vietnam	vietnam hands 5 heroin traffickers death penalty
sexual assault a ' scourge ' on us military , hagel says	obama : sexual assault threatens trust in military
saudi women 's driving kicks off without arrests	saudi women drive in protest with little problem
bomb in damascus kills 13 day after attack on prime minister	syrian tv : bombing in damascus kills 13 people
un warns of plight of women , children in syria 's homs	unicef calls for immediate safe access to women , children in homs
algeria 's president bouteflika in hospital	algerian president suffers ' mini stroke'
nobel prize-winning south african writer nadine gordimer dead at 90	south africa remembers nadine gordimer
redford touts alberta economy ahead of vote on leadership	redford addresses pc convention ahead of leadership review
hagel , dempsey face congress over defense budget	hagel laments " political " changes to us defence budget
sony to sell pc unit and cut jobs	sony to axe pc unit in major business overhaul
two explosions rock boston marathon at finishline	two blasts hit boston marathon finish line , at least two killed
cambodian opposition says poll irregularities worst ever	cambodian opposition claims surprise win ahead of result
mahathir resigns as adviser to petronas	former malaysian pm mahathir quits as adviser to state oil giant petronas
crimea votes to leave ukraine for russia	putin defiant as crimea votes to return to russia
man kills 4 in calif. before police shoot him dead	police : gunman killed 6 in california shootings
iran nuclear talks conclude without a deal	french fm fabius says iran nuclear talks end without deal
spain train-crash driver accused of ' recklessness'	police detain spain train crash driver as suspect
still no sign of malaysian airline lost in unprecedented mystery	malaysia airlines lost plane : nations rush to solve ' unprecedented mystery'
petra kvitova schools eugenie bouchard in wimbledon women 's final	kvitova blitzes bouchard in a lopsided final
n . korea deports elderly american	north korea deports detained us war veteran
nelson mandela making " amazing progress " as world celebrates his 95th birthday	nelson mandela celebrates 95th birthday in hospital
retiring cricket legend sachin tendulkar recieves india 's highest civilian award	sachin tendulkar to get bharat ratna , india 's highest civilian honour
taliban attack presidential palace in afghanistan	all gunmen in attack on afghan presidential palace killed
court clears dana 's brother of all counts of historic sex abuse	dana 's brother john brown cleared of two sexual abuse charges
jury in george zimmerman trial faces tough task	jury to get zimmerman case
eurozone unemployment hits record-high 12.2 %	unemployment hits record high in europe
turnout low , egypt extends presidential vote a day	egypt 's presidential vote goes to a 3rd day
north korea readying for fourth nuclear test	n . korea may be preparing new nuclear test-report
faa approves boeing dreamliner battery system design	u.s. regulator approves boeing 787 battery system design changes
search leader urges caution in findings related to missing malaysian jetliner	searchers hoping pings come from lost malaysian airliner
summers quits race for fed job	stocks buoyed by summers ' withdrawal from fed race
south sudan state launches army recruitment drive	south sudan ( republic of ) : south sudan rivals discuss ceasefire , detainees
no deal on iran 's nuclear program , despite ' concrete progress'	iran 's rouhani says nuclear rights are ' red lines'
egypt 's hosni mubarak released from prison	court orders mubarak freed
mandela 's remains arrive in mthatha before burial	mandela makes final journey home in safrica
south korea expands its air defense zone in reaction to china	south korea declares expanded adiz overlapping with other zones
mandela remembered by family , as stadium memorial service is planned	mandela 's family thanks nation and world for support
conditions good for costa concordia righting attempt	engineers start ambitious costa concordia salvage off italian island
protests after george zimmerman acquitted in trayvon martin case	zimmerman acquitted in slaying
china-myanmar exchange ends in sw china	myanmar welcomes more china exchanges
un chief lauds awarding of nobel peace prize to opcw	chemical arms watchdog wins nobel peace prize
pope makes peace plea during bethlehem visit	pope calls for peace during west bank visit
poroshenko sworn in as ukraine president	poroshenko says ukraine will not give up crimea
dubai dazzles in global 2014 party , new year welcomed with joy , fireworks	dubai rings in the new year with largest fireworks show ever
amid signs of deal , kerry heads to iran nuke talks	kerry heads to geneva for iran nuclear talks
obama holds talks over syria action	syria action ' would not cause radicalisation'
sharif stages comeback in landmark pakistan election	nawaz sharif declares victory in pak elections
cheeki rafiki found but no sign of crew	missing yacht found , but no crew
peaches geldof , daughter of bob geldof , dies	peaches geldof dies aged 25
why did british parliament vote against military action in syria ?	cameron loses parliamentary vote on syria military action
obama , cameron ' no doubt ' syria regime waged chem attacks	biden : no doubt syria regime used nerve agent
seven dead in california college shooting	7 killed in california drive-by shooting
iran makes proposal aimed at progress in nuclear talks	israel urges powers to be tough in nuclear talks with iran
syria says u.n. will get access to site of possible chemical attack	syria allows un visit to chemical attack site
bank of england holds rates as mervyn king bows out	bank of england says no to more qe
crowds wait for verdict in zimmerman trial	the race factor in george zimmerman 's trial
with bags of cash , cia seeks influence in afghanistan	aircraft crashes at base in afghanistan
ukrainian presidency says deal reached at crisis talks	ukraine rivals sign deal to end crisis
federal judge rules that same-sex marriage is legal in utah	judge strikes down utah 's same-sex marriage ban
obama prepares for possible action against syria	uk parliament blocks british military action against syria
mattel profit slumps as barbie 's appeal continues to fades	mattel 2q profit falls , barbie sales slide again
crimea 's pro-russian parliament approves declaration on independence	ukraine v russia : diminishing russian international influence ?
obama mulls limited military action in syria	obama urges military action against syria , but will seek congress ' ok
immigration bill clears key vote and could be passed by senate this week	immigration reform passes key senate test
russian parliament approves use of army in ukraine	associated press : pro-russia demonstrations break out in ukraine
syrian death toll has reached nearly 93,000 , says un	syrian conflict death toll now over 93 000 , un says
army overthrows egyptian president morsy	world concern over ouster of egypt 's president
australia sends troops to protect its embassy in baghdad	troops sent to protect embassy
president obama to seek approval from congress before taking action in syria	france to await u.s. congressional decision on syria
iranian agency drops rafsanjani remarks critical of syrian government	u.s. , french presidents vow to punish syrian government
toyota , honda , nissan and mazda recall 3 million japanese cars after airbag fault	honda , nissan and toyota in massive recall over airbag inflators
shashi tharoor admitted to aiims	shashi tharoor hospitalised after chest pain
new year celebrations around the world	revelers around the world ring in 2014
thai anti-government protest leader shot dead in bangkok violence-police	thai protesters obstruct vote ; 1 dead in violence
five dead , 40 missing in canada train disaster	death confirmed in canada train blast
hot air balloon ' catches fire and crashes'	hot-air balloon crashes in va . ; 3 missing
french leader to await us congress vote on syria	france waits on us vote over syria strikes
4 french journalists freed after 10 months in syria	kidnapped french journalists found on turkey 's syrian border
obama to give major climate change speech	the caucus : obama to unveil climate plan on tuesday
france welcomes us-russia deal on syria	us-russia reach agreement on syria
stocks rise after summers exits fed race	us dollar dips as lawrence summers quits federal reserve race
syria 's pm escapes assassination try , regime says	syrian prime minister survives assassination attempt
polls open in afghanistan 's presidential run-off election	afghanistan begins run-off votes for presidential election
29 dead in 3 days of sudan riots	bloody days in sudan
george zimmerman found not guily of trayvon martin murder	live blog : george zimmerman not guilty
u.s. al-qaeda raids in somalia , libya trigger backlash	us captures al-qaeda leader in libya ; raids somalia
us confirms use of chemical weapons by syrian regime	the us must show evidence of syria 's use of chemical weapons
sri lankan asylum seekers win temporary reprieve from australia	sri lankan asylum seekers facing criminal investigation after being handed back by australian authorities
swedish court rules wikileaks founder to remain in detention	swedish court upholds detention order on wikileaks founder assange
nineteen hurt in mother 's day shooting in new orleans	police vow to solve shootings of 19 in new orleans
burma promises to free all political prisoners by year 's end	myanmar to free political prisoners
obama holds out over syria strikes	uk urges countries over syria aid
one killed in clashes at muslim brotherhood cairo offices	syria mocks egypt muslim brotherhood model
sailors dead in india submarine blast	several indian sailors dead after submarine explodes and sinks
t.s.a. officer is killed at los angeles airport	obama ' concerned ' about los angeles airport shooting
5 die in christian-muslim clashes in egypt	egypt call for calm after deadly christian-muslim clashes
jordan elected to take saudi seat on un security council	jordan elected to un security council seat that saudi arabia rejected
taliban claim deadly attack on karachi airport	fresh gunfire at karachi airport
maldives begins to vote in controversy-ridden presidential poll	crisis-hit maldives holds new presidential poll
south africa remembers nadine gordimer	author nadine gordimer dies at 90
james gandolfini of ' sopranos ' fame dead at 51	actor james gandolfini , 51 , dies of cardiac arrest
21 elderly patients die in south korean fire	fire at hospital for elderly kills 21 in south korea
at least 18 killed in iraq mosque bombing	more than 60 killed at iraq funeral
police surround protesters in belfast ahead of g8	peaceful anti-g8 protest held in belfast
egypts muslim brotherhood rejects cabinet offer	egypt orders arrest of brotherhood leaders
malaysia plane carrying 239 people missing	malaysia pm says still no sign of missing plane
malaysia airlines flight missing	malaysia airlines passenger plane feared crashed
tornadoes level homes in oklahoma , 1 dead	video : video : tornado destruction in carney , oklahoma
pope francis arrives in jordan	pope to start delicate middle east trip in jordan
3 injured in gunmen attack in kabul	gunmen attack shi 'ite mosque in kabul
7.2 quake hits central philippines , killing 85	7.2 magnitude earthquake strikes philippines
turkish riot police fire tear gas at istanbul protest	video : turkey showdown : riot police take on protesters
turkey protesters ' to stay in park ' despite pm concession	turkish protesters refuse to leave istanbul park despite erdogan 's pledge
libyan army chief resigns after clashes in benghazi kill 31	libya army chief quits after unrest
thousands join victory day march in donetsk	vladimir putin attends victory day parade in moscow
facebook content to take over entire homescreen	facebook starts to unveil ' new home on android'
titanic memorabilia fetches thousands at auction	titanic violin sells for over $ 1.6m at auction
chinese premier solicits expert opinions on economic growth	xi : china confident of sustainable economic growth
turkish police fire tear gas , water cannons to clear park	riot police disperse protesters in istanbul park
divers pull bodies from sunken ferry ; toll tops 50	south korea sunken ferry death toll ' reaches 50'
afghan taliban releases video showing us soldier hand-over	taliban video shows handover of us soldier
afghan presidential election heads for a run-off in june	afghan election board to release final results
obama arrives in malaysia ; third stop on asia tour	president obama on third stop in trip to asia
yahoo ! promises tumblr bloggers ' light ' advertising	yahoo ! confirms tumblr deal for $ 1.1 billion
as mandela 's condition improves , south africa 's anxiety remains	mandela responding to treatment , south africa 's zuma says
tearful oscar pistorius apologises	'i have terrible nightmares - i can smell blood ' : recap as oscar pistorius begins murder trial testimony
george zimmerman found not guilty of trayvon martin murder	george zimmerman verdict propels cable news into talkradio mode
osborne says not worried about house prices	george osborne says deficit can be eradicated without further tax rises
death toll of china quake rises to 180 dead	death toll rises to 179 in china quake
wayne rooney did ask to leave manchester united , alex ferguson reveals in new book	sir alex ferguson autobiography overview : wayne rooney urged manchester united to sign mesut ezil ' before asking to leave'
ten rescued off waterford , dublin coasts	six rescued after boat capsizes in dublin bay
cannes hotel raid nets 40 million gems	jewels worth 40m stolen in cannes
putin declares sochi winter paralympics open	putin opens paralympics as protest staged
child prostitution raids rescue 105 young people	us child prostitution crackdown leads to fbi making 150 arrests
north korea vows to restart nuclear facilities	south korea vows fast response to north ; u.s. positions destroyer
france takes tough line at iran nuclear talks	japanese fm visits iran for talks
gunmen kill 9 foreign tourists , 1 pakistani	gunmen storm hotel , kill foreigners
sudan frees christian woman sentenced to death for apostasy	meriam ibrahim : sudanese apostasy woman ' re-arrested ' with family at airport
ukraine 's parliament votes to dismiss president	ukraine 's opposition chief wants more protests
mandela spends third day in hospital	mandela in hospital for 3rd day
google now has 1b active monthly android users	google officially unveils android tv
flooding after heavy rain warning	flood alerts issued as rain sweeps across country
thai house dissolved , yet protests persist	thai prime minister dissolves parliament
one killed in clashes at muslim brotherhood cairo offices	egypt : protesters storm muslim brotherhood 's hq
security tight at miss world final in indonesia	dozens still missing after boat sinks in indonesia
syrians detonate bomb against israeli patrol on golan border	bomb explodes near israel patrol in golan ; no casualties
snowden said to seek asylum in ecuador , iceland	snowden ' given refugee document by ecuador'
beijing-bound flight from malaysia missing	flight from malaysia to beijing has lost contact
plane search focuses on debris	missing mh370 : planes sent to check 2 objects
saudi women to protest against driving ban	saudi women drive in protest with little problem
obama , hollande hail transformed us-french relationship	hollande arrives for us state visit
boston bombers bring echo of chechnya 's legacy of violence	boston bombing suspects not connected with chechnya
russian parliament allows putin to use military in ukraine	president obama warns russia to stay out of ukraine
3 blasts in patna ahead of modi 's rally ; 1 dead , 5 injured	blasts kill 5 at modi rally in patna
germany welcomes iran nuclear agreement	french foreign minister : iran nuclear deal reached
qatar , turkey and iran condemn violence in egypt	u.n. chief ban ki-moon condemns crackdown in egypt
bolivia vs . europe over snowden-linked plane delay	bolivian leader 's plane rerouted on snowden fear
woman dies after newport shooting	woman dies and man seriously injured after shooting in newport street
rival rallies disrupt start to ramadan	egypt rival rallies planned amid soaring tensions
petra kvitova wins wimbledon women 's title	petra kvitova crushes eugenie bouchard to claim second wimbledon
man arrested in car bomb plot at kan. airport	feds : man planned kan. airport attack
nelson mandela hospital release reports ' incorrect'	nelson mandela goes home after hospital stay
putin defends russian action in ukraine to merkel	nato says russian action threatens peace in europe
funeral service held for margaret thatcher	queen , leaders to bid farewell to thatcher
man killed in deadly terror attack in london street	soldier hacked to death in london
malaysian polls open in pivotal election	huge turnout in malaysian national elections
egypt court bans all muslim brotherhood activities	muslim brotherhood banned in egypt
world stocks rise on hopes fed to keep stimulus	fed expected to maintain stimulus
no winners in a war of sanctions	the impact of sanctions on russia
brazil protesters to march in 80 cities	brazil protests tap into frustration of have-nots
south korean soldier reportedly flees after killing 5 comrades at border with north korea	south korean soldier kills comrades and flees
merkel presses putin to help calm ukraine	red cross staff detained for ' espionage ' in ukraine
bjp may win 5-7 seats in delhi , opinion poll says	bjp may win more than 40 seats in up survey
rocky road ahead for egypt president-elect sisi	profile : egyptian president-elect abdel fattah al-sisi
murray first gb men 's wimbledon champion since 1936	andy murray wins historic wimbledon title
china , eu reach settlement on solar panels	europe and china agree to settle solar panel fight
cannes ' second jewellery heist in months	cannes thief stole jewels from hotel 's leviev exhibition
egypt court sentences 102 islamists to 10 years in jail	egyptian court jails 102 morsi supporters
putin ' not decided whether to send troops to ukraine yet'	vladimir putin asks parliament for permit to send troops to crimea
thai capital 's emergency center says 4 wounded in blast at anti-government protest site	28 wounded in blasts at bangkok protest site
oscar pistorius ' friend recounts gunshot incident at restaurant	oscar pistorius ' accidentally fired bullet in crowded restaurant - then asked friend to take blame'
wife of india minister found dead after twitter spat	indian minister 's wife died ' unnatural ' death , autopsy shows
us warms to syria chemical amnesty plan	russia , syria work on ' concrete ' chemical weapons plan
new york buildings collapse toll rises to seven	nyc buildings explosion kills 4 others missing
iran nuke talks to be extended for 4 months	iran nuclear deadline extended to nov 24
india inducts c-17globemaster-iii into iaf	indian air force inducts first three c-17s into service
world cup hit by new stadium death	worker dies at world cup stadium
egypt calls for international community to act against israel 's aggression on gaza	pakistan condemns israeli aggression in gaza
ukraine president 's whereabouts unknown	ukrainian president compares situation in kiev to nazi germany
tata nano and other indian small cars fail crash tests	how does world 's cheapest car do in crash test ?
hundreds besieged in egypt 's fateh mosque	dozens die in egypt bloodbath
three israeli teens missing in west bank	massive search launched for 3 teens feared kidnapped in west bank
ireland exits bailout with last tranche of imf aid	ireland free from bailout shackles but not out of woods
israel agrees to ' humanitarian ' pause in air strikes ; 4 boys killed playing on gaza beach	srael naval strike kills children on gaza beach
greece reaches agreement with troika , bailout tranche expected within days	debt inspectors reach agreement with greece
indian village council orders gang-rape of woman as pun ...	kangaroo court in eastern india allegedly orders gang rape of woman
north korea severs final link with south in new escalation of nuclear crisis	north korea may be preparing new nuclear test
prince william and wife kate present the baby prince	world waits to meet new prince
shootings at mother 's day parade in us	17 wounded in shooting at new orleans parade
briton among 50 dead in russia plane crash	russia seeks answers over deadly plane crash
china quake leaves 181 dead , 24 missing	sichuan earthquake leaves devastation - in pictures
china urges early action on syria weapons deal	watchdog gets details of syrian chemical arsenal
missing nigerian schoolgirls start second month in captivity	nigerian girls missing for a month
murray ends 77-year wait for british win	murray wins wimbledon title ends britains 77year agony
malaysia airlines plane crashes on ukraine-russia border - live	us : russia massing troops on ukraine border
france threatens google with privacy fines	google threatened with contempt of court over privacy breach
direct military action will require a further commons vote	forest whitaker ' we all share a common bond'
syrian gov 't , opposition to meet in ' same room'	syria warring sides not in same room for start of talks
pakistan , india trade fire along kashmir border	pakistan military says officer killed by indian fire in kashmir
heathrow runways closed after ba plane makes emergency landing	ba jet makes emergency landing after engine fire
tycoon claims win in ukraine and promises to seek future in eu	polling stations open at ukrainian presidential election
us to determine extent of chemical weapons use by syria	what we know so far about chemical weapons in syria 's civil war
egypt on brink as crowds mass	egypt tense as army deadline looms
jodi arias jury to choose death penalty or life	arizona jury finds arias eligible for death penalty in ex-boyfriend 's slaying
why mitch mcconnell isn 't as doomed as this poll would have you believe	mitch mcconnell tied in new poll . does he miss ashley judd yet ?
royal baby 's birth leaves grandfather prince charles " overjoyed " for william and kate	royal baby on the way ; catherine enters hospital in labor
the covert war in pakistan	new major earthquake rocks southwest pakistan
obama hails mandela 's inspiration effect	obama meets with mandela family
qantas bill heads to a hostile senate	qantas closer to foreign ownership
morsi supporters protest in egypt	morsi backers defiant in face of egypt govt threat
rescue efforts continue in korean ferry disaster	anger spreads over korean ferry sinking
88yearold nd tiwari marries mother of his biological son	india 's nd tiwari marries son 's mum
bangladesh to allow unions for garment workers	bangladesh collapse search over ; death toll 1,127
syria agrees to surrender chemical weapons	uk 's cameron : syria , russia must show chemical arms proposal is genuine
russia 's putin claims authority to invade ukraine	kremlin : putin yet to decide on using russian troops in ukraine
senior cpc official meets top dprk leader 's special envoy	north korean leader sends ' special envoy ' to china
us issues global travel alert , citing-al qaida	state dept. issues wide travel alert , says terror attack possible
french release terror suspect but charge him for inciting racial hatred	france drops terror charges against musician
turkey unrest goes on despite end to park protest	turkish pm erdogan says " duty " to order crackdown on istanbul park protest
boko haram says video shows missing nigerian girls	nigerian schoolgirls : boko haram releases new video , offers trade of schoolgirls for militant prisoners
oil prices mixed in asia	oil prices mixed in asian trade
headlines in major iranian newspapers on aug 5	headlines in several iranian newspapers on oct 19
top asian news at 12 : 30 p.m. gmt	top asian news 7 : 48 a.m. gmt
top asian news 7 : 48 a.m. gmt	top asian news at 11 : 00 p.m. gmt
china treasury bond futures open slightly lower wednesday	china treasury bond futures close higher tuesday
indian stocks open lower	indian stocks close lower
nurse first to contract ebola outside africa	spanish nurse first to contract ebola outside africa
pope calls for action on climate change in draft encyclical	pope urges action on climate change in draft encyclical
headlines in major iranian newspapers on aug 5	headlines in major iranian newspapers on sept 27
headlines in major iranian newspapers on aug 5	headlines in major iranian newspapers on sept 24
nigeria confirms 2nd ebola case	nigeria confirms 2 new ebola cases
is jihadists kidnap 90 christians in syria : monitor	is kidnap 90 christians in syria : monitor
inspired nishikori ready for london atp final	inspired nishikori ready for london atp final
top asian news at 2 : 30 p.m. gmt	top asian news at 10 : 00 a.m. gmt
19 killed in tunis museum attack	21 killed in tunisia museum gun attack
oil prices down in asian trade	oil prices mixed in asian trade
kerry cautious before new iran talks , cites ' important gaps'	kerry cautious before new iran talks , cites ' important gaps'
gaza 's summer training camps : ' no time left for playing ' aug . 11 , 2015	gaza 's summer training camps : ' no time left for playing'
singapore shares open 0.28 % lower on thursday	singapore shares open 0.19 % higher on thursday
how the dow jones industrial average fared on monday	how the dow jones industrial average fared on wednesday
who is jihadi john ?	who was ' jihadi john ? '
target raises earnings forecast after profit rises	target raises 2015 earnings forecast after profit jumps
how the dow jones industrial average fared friday	how the dow jones industrial average did monday
iraqi shi 'ite militia kill dozens of sunnis in mosque shooting	shi 'ite militia kill dozens of iraqi sunnis in mosque shooting
twitter sues over government surveillance	twitter sues us government over surveillance
china hushen 300 index futures open higher thursday	china hushen 300 index futures open mixed friday
how the dow jones industrial average did friday	how the dow jones industrial average fared on friday
how the dow jones industrial average fared on monday	how the dow jones industrial average fared on thursday
top asian news at 1 : 30 a.m. gmt	top asian news 11 : 42 a.m. gmt
iran , iaea officials meet ahead of march nuclear deadline	iran , iaea officials meet ahead of march nuclear deadline : isna
how the dow jones industrial average did friday	how the dow jones industrial average fared tuesday
headlines in major iranian newspapers on oct 4	headlines in several iranian newspapers on oct 19
indian stocks close lower	indian stocks close higher
10 things to know for wednesday	10 things to know for today
foreign exchange rates in india	foreign exchange rates in thailand
singapore shares open 0.35 % higher on wednesday	singapore shares open 0.19 % higher on thursday
pakistan : daily emergency & amp ; response situational information report , 25 october 2014	pakistan : pakistan : daily emergency and response situational information report , 22 september 2014
bombings kill 9 people in iraqi capital	bombings kill 19 people in iraq
your morning read for sunday , september 6 , 2015 in toronto	your morning read for sunday , july 12 , 2015 in toronto
top asian news 1 : 25 p.m. gmt	top asian news 7 : 48 a.m. gmt
news of terrorism and the israeli-palestinian conflict ( october 7 - 21 , 2014 )	news of terrorism and the israeli-palestinian conflict ( june 24-30 , 2015 )
how the dow jones industrial average fared on thursday	how the dow jones industrial average fared friday
how the dow jones industrial average did monday	how the dow jones industrial average did thursday
world news update , what you need to know	finance news update , what you need to know
us attorney general holder resigns	us attorney general eric holder to resign
u.s. , eu widen sanctions on russia	u.s. , eu boost sanctions on russia
10 things to know for wednesday	10 things to know for thursday
oil rises in asian trade	oil prices down in asian trade
how the dow jones industrial average fared on thursday	how the dow jones industrial average did friday
foreign exchange rates in india	foreign exchange rates in singapore
how the dow jones industrial average did monday	how the dow jones industrial average fared on friday
top asian news at 9 : 00 a.m. gmt	top asian news 8 : 39 a.m. gmt
top asian news 7 : 48 a.m. gmt	top asian news at 9 : 30 a.m. gmt
top asian news at 2 : 30 p.m. gmt	top asian news 1 : 25 p.m. gmt
top asian news at 9 : 30 a.m. gmt	top asian news 4 : 39 p.m. gmt
top asian news at 7 : 00 a.m. gmt	top asian news 8 : 39 a.m. gmt
avengers star patrick macnee dies	the avengers star patrick macnee dies aged 93
how the dow jones industrial average did friday	how the dow jones industrial average did wednesday
your morning read for sunday , july 19 , 2015 in toronto	your morning read for monday , march 30 , 2015 in toronto
how the dow jones industrial average did wednesday	how the dow jones industrial average fared on monday
how the dow jones industrial average fared on friday	how the dow jones industrial average fared tuesday
how the dow jones industrial average fared on tuesday	how the dow jones industrial average did thursday
dead comet with skull face skims past earth on halloween	dead comet with skull face to hurtle by earth on halloween
hajj to go ahead despite crane collapse , officials vow	hajj to go ahead despite crane collapse
oil prices rise further after gains in asia	oil prices rise further in asia
latest from osce special monitoring mission ( smm ) to ukraine , based on information received as of 19 : 30hrs , 16 october 2015	ukraine : latest from osce special monitoring mission ( smm ) to ukraine based on information received as of 18 : 00 ( kyiv time ) , 28 september 2014
10 killed in nigeria bombings	71 killed in syria bombing
13 pkk rebels killed in turkey 's military operations	61 rebels killed in military operations
egypt court postpones morsi death sentence ruling	egypt court confirms morsi death sentence
at & amp ; t helped u.s. nsa in spying on internet traffic : n.y. times	at & amp ; t helps u.s. spying on internet : n.y.times
top asian news 11 : 42 a.m. gmt	top asian news at 9 : 00 a.m. gmt
top asian news 11 : 42 a.m. gmt	top asian news at 2 : 00 a.m. gmt
oil rises in asian trade	oil falls in asian trade
pope welcomed to central african republic	pope meets muslims in central african republic
shanghai stock indices close higher on friday	china stocks close higher on friday
powerful earthquake hits eastern japan	powerful earthquake hits nepal
facebook activates safety feature after nigeria bombing	facebook activates safety feature after yola bombing
avengers star patrick macnee dies aged 93	avengers star patrick macnee has died at the age of 93
canada 's batty , pendrel win gold , silver in women 's mountain bike	canada 's pendrel , batty win gold , silver in mountain bike
isis brings its war to lebanon - and it could be a key part of abu bakr al-baghdadi 's masterplan	isis brings its war to lebanon - and it could be key to a masterplan
7.3-magnitude quake hits devastated nepal	7.9-magnitude quake hits nepal
us house republicans elect paul ryan as speaker	us house republicans eye reluctant ryan for speaker
cease-fire in gaza ends	ceasefire in gaza underway
suspected us drone strike kills 9 in afghanistan officials	suspected us drone strike kills 6 in pakistan
top asian news at 9 : 00 a.m. gmt	top asian news 4 : 39 p.m. gmt
top asian news 1 : 25 p.m. gmt	top asian news at 4 : 30 a.m. gmt
top asian news at 1 : 00 p.m. gmt	top asian news 7 : 48 a.m. gmt
top asian news at 1 : 00 p.m. gmt	top asian news 8 : 39 a.m. gmt
top asian news at 4 : 00 p.m. gmt	top asian news 3 : 12 a.m. gmt
top asian news at 4 : 00 p.m. gmt	top asian news 8 : 39 a.m. gmt
singapore shares open 0.35 % higher on wednesday	singapore shares open 0.06 % lower on tuesday
singapore shares open 0.83 % higher on wednesday	singapore shares open 0.06 % lower on tuesday
china treasury bond futures open higher tuesday	china treasury bond futures close mixed wednesday
at least 59 dead , 600 missing after massive mudslide in guatemala	at least seven dead , scores missing after mudslide in guatemala
nigeria declares national emergency over ebola	nigeria declares a state of emergency over ebola crisis
foreign exchange rates in thailand	foreign exchange rates in singapore
how much do you know about isis ?	how much do you know about secret service ?
mali : security council press statement on mali	yemen : security council press statement on yemen
how the dow jones industrial average did friday	how the dow jones industrial average fared on monday
how the dow jones industrial average did friday	how the dow jones industrial average fared wednesday
22 killed in iraq bombings	71 killed in syria bombing
5 things to know for your new day -- friday , august 28	5 things to know for your new day -- wednesday , july 15
ebola outbreak : keep up to date	ebola outbreak : get up to speed
chinese shares open higher thursday	chinese shares open lower friday
who : ebola death toll rises to 729	who : ebola death toll reaches 932
us attorney general holder resigns	attorney general eric holder to resign
female suicide bomber kills two in nigeria	female suicide bombers attack in nigeria
us : health worker tests positive for ebola	2nd us health care worker tests positive for ebola
headlines in major iranian newspapers on sept 27	headlines in several iranian newspapers on oct 19
abbvie sours on $ 55b shire deal after tax changes	abbvie cools on $ 55bn shire deal after us tax changes
austria now says over 70 bodies thought to be of migrants were in truck	austria finds up to 50 bodies thought to be of migrants in truck
sierra leone declares state of emergency over ebola ( updated )	sierra leone president declares state of emergency over ebola
osce special monitoring mission to ukraine deputy chief monitor alexander hug to visit donetsk	ukraine : osce special monitoring mission to ukraine deputy chief monitor to visit southeast ukraine
state department to release more of hillary clinton 's emails	us state department releases hillary clinton emails
chinese yuan strengthens to 6.3665 against usd tuesday	chinese yuan weakens to 6.3459 against usd friday
china treasury bond futures open higher tuesday	china treasury bond futures close mixed friday
5 things you need to know wednesday	5 things you need to know this weekend
6.1-magnitude quake hits bay area	7.9-magnitude quake hits nepal
u.s. to provide $ 351 million for israel 's iron dome	us approves $ 225 million for israel 's iron dome
china on high alert for typhoon kalmaegi	china issues yellow alert for typhoon kalmaegi
south korea declares end to mers outbreak	fourth korean dies in mers outbreak
china treasury bond futures close higher monday	china treasury bond futures open slightly lower wednesday
s . korea cuts key rate as mers emerges as threat to recovery	south korea cuts key rate as mers feared to slow recovery
deadly tornadoes strike central u.s.	5 dead as tornadoes blast central u.s.
yemen rebels refuse to board plane for geneva peace talks	yemen rebel delegation arrives for geneva peace talks
chinese yuan strengthens to 6.1318 against usd wednesday	chinese yuan weakens to 6.1402 against usd monday
a tale of two fathers	a tale of two trumps
saudi-led airstrikes hit yemeni capital	saudi airstrikes in yemen 's capital kill 29
7.0-magnitude quake hits 42km east of tambo , peru -- usgs	7.5-magnitude quake hits 35 km east of lamjung , nepal : usgs
nigerian president vows to hunt mosque attackers	nigerian president orders probe into mosque attack
islamic state militants raze iraq 's ancient hatra city	islamic state militants bulldoze ancient nimrud city
iran nuclear talks head into overtime	iran nuclear talks shift into top gear
new un peacekeeping chief named for central african republic	un takes over peacekeeping in central african republic
us launches airstrikes against isis	us launches first airstrikes against is in syria
german intelligence recorded clinton , kerry calls	german intelligence reportedly spied on kerry , clinton calls
hundreds dead as strong quake hits southwest china	at least 367 dead after quake hits southwest china
hundreds dead as strong quake hits southwest china	at least 150 dead after quake hits southwest china
iceland lowers aviation alert on volcano	iceland lowers volcano alert to orange
clinton apologises for use of private email account	no clinton apology over her use of private email
s . korea reports 11th death from mers outbreak	s . korea reports 7th mers death , vows to end outbreak
militant attack from afghanistan kills four in upper dir	militant attack from afghanistan kills fc soldier in balochistan
17 killed as bus falls into gorge in almora	22 dead as bus falls into gorge in j & k
computer glitch grounds aeroplanes	computer glitch grounds us flights
occupied palestinian territory : saudi arabia donates $ 12 million to aid palestinian refugees	occupied palestinian territory : saudi arabia promises $ 500 million for gaza rebuilding
u.s. ebola patient takes a turn for the worse	ebola patient in dallas takes turn for worse
5.5-magnitude quake hits indonesia -- usgs	5.7-magnitude quake hits 140 km wsw of naze , japan -- usgs
at least 3 killed in pakistan blast	at least 39 killed in iranian plane crash
mali hunts jihadist nightclub killers	militants attack un as mali hunts jihadist nightclub killers
7.3 magnitude earthquake strikes nepal	6.6-magnitude earthquake strikes off indonesia
greece defers € 300m imf payment	greece defaults on imf payment
top isis leader killed in airstrike	isis leader hit by airstrike
tokyo shares open higher over buoyant u.s. market	tokyo shares open higher tracing u.s. gains
iran 's parliament backs nuclear deal	iran hardliners attack nuclear deal
17 taliban killed in n . afghanistan	taliban bomb kills 29 in afghanistan
malaysia airlines jet makes emergency landing in australia after ' engine fire'	turkish airlines plane makes emergency landing after engine fire
turkish jets strike kurds in iraq , islamic state in syria	turks help iraqi kurds fight islamic state in syria
us-led air strike kills al-qaeda leader in syria : pentagon	u.s. launches airstrike against al-qaida leader in libya : pentagon
israeli tanks strike gaza after rocket fired	israel renews air strikes on gaza after rocket fire
yemen separatists leave un-sponsored talks	yemen separatists suspend participation in un-sponsored talks
sierra leone to shut down for 3 days to slow ebola	sierra leone to cordon off 3 areas to stop ebola
israeli forces shoot , kill palestinian attacker in west bank	israeli police shoot , kill palestinian woman in hebron
greece defers € 300m imf payment	greece delays € 300m payment to imf
hong kong stocks close 1.27 pct higher	hong kong stocks close higher by midday
brazil to hold general elections on sunday	denmark to hold general election on june 18
how vw scandal could be diesel 's death knell	could volkswagen scandal be diesel 's death knell ?
netanyahu : iran nuclear deal threatens israel 's existence	netanyahu : iran nuclear plan threatens world
burundi police fire tear gas , beat anti-president protesters	burundi police fire tear gas in protest against president
britain launches airstrikes on isis in syria	uk to launch air strikes against is in syria
google 's self-driving cars have had 11 accidents	google 's self-driving cars involved in 11 crashes
hawaii preps for first hurricane in 22 years	hawaii bracing as first hurricane in 22 years approaches
israeli forces detain 4 palestinians at aqsa compound sit-in	israeli forces detain 12 palestinians overnight
ebola survivors ' blood on black market	ebola survivor donates blood to ebola patient
iraq bombings kill at least 26	iraq suicide bomber kills at least 12
taiwan stocks close 0.77 pct lower	indian stocks close lower
tokyo shares open higher following overnight u.s. gains	tokyo shares open higher on buoyant u.s. market
eu and us. announce new sanctions on russia over ukraine	japan imposes sanctions on russia over ukraine
ukraine inspects russian ' aid ' convoy	ukraine minister denounces russian aid convoy
sierra leone in ebola lockdown	sierra leone reaches final day of ebola lockdown
5.5-magnitude quake hits western iran	6.1-magnitude quake hits bay area
tokyo shares open higher on buoyant u.s. market	tokyo shares open higher following strong u.s. performance
tianjin warehouse blast death toll rises to 104	tianjin blasts death toll rises to 114 , 70 missing
jim carrey 's girlfriend found dead , suicide suspected	jim carrey 's girlfriend found dead
russia takes bit out of mcdonald 's	russia takes bite out of mcdonald 's in ' new cold war'
oil falls in asian trade	oil prices down in asian trade
israeli forces detain palestinian mp in hebron	israeli forces detain 2 palestinians in overnight arrest raids
hong kong 's protesters aren 't backing down	why hong kong 's protests are a big deal
police and protesters clash in hong kong	police clear protesters from hong kong hq
nepal earthquake death toll surpasses 7,000	nepal quake toll crosses 5,000
hajj to go ahead after mecca crane collapse kills 107	hajj to go ahead despite crane collapse
students killed in berkeley balcony collapse mourned in ireland	5 irish students killed in berkeley balcony collapse , officials say
12 killed in roadside bombings in afghanistan	13 killed in mosque bombings in nigeria
secretary kerry travel to baghdad , iraq	secretary kerry 's travel to russia and turkey
live tv now drive it ! 03 : 00 utc dw news	live tv now focus on europe 05 : 00 utc dw news
gaza ceasefire takes hold as focus turns to longer term	gaza cease-fire takes hold as negotiators gather
7.3-magnitude quake hits devastated nepal	8.1-magnitude earthquake hits nepal
nigeria dispels rumour of more ebola cases	nigeria confirms 1 more ebola case
driver hits pedestrians in jerusalem	five hurt in car attack on pedestrians in jerusalem
avengers star patrick macnee dies	avengers star patrick macnee has died at the age of 93
china stocks close higher on monday	china stocks close lower thursday
soldier killed in canada shooting	three killed in california shooting
two killed in suspected boko haram attacks on voters in ne nigeria	suspected boko haram attacks kill dozens in nigeria
kenyan kimetto breaks marathon world record	dennis kimetto sets new marathon world record in berlin
north korean soldier walks across dmz in bid to defect to south	north korean pair swim across sea border to defect to south korea
us stocks mixed in midday trading	us stocks slide in midday trade ; airlines sink
us stocks-wall st up 1 pct as china fears ease	us stocks-wall st jumps 2 pct ; eyes on china
ied attack kills police chief in iraq 's anbar	ied attack kills two people in iraq 's baghdad
chinese premier holds talks with german chancellor	chinese premier meets british chancellor
thousands of syrian kurds flee to turkey as is advances	thousands of syrian kurds flee into turkey to escape islamic state offensive
china : at least 150 dead , 180 missing in sw china quake	china : at least 10 dead in sw china rainstorms
hundreds of rescued migrants and refugees arrive in cagliari	thousands of migrants and refugees arrive in germany
4 killed , several injured in sw china car accident	two killed , seventeen injured in raiwind road accident
protest erupts during world indigenous games in brazil	protests mar opening of world indigenous games
syrian arab republic : under-secretary-general for humanitarian affairs and emergency relief coordinator , valerie amos : security council briefing on syria - new york , 26 march 2015	syrian arab republic : united nations under-secretary-general for humanitarian affairs and emergency relief coordinator , stephen o 'brien statement to the press on syria
ebola death toll rises to 887 : who	ebola death toll rises to at least 2,296
six civilians killed in fresh fighting in eastern ukraine	9 killed in fighting in eastern ukraine
israeli forces arrest 12 palestinians in west bank	israeli settlers set ablaze palestinian land in west bank
army air strikes kill 28 militants in nw pakistan	airstrikes , gunfight kill 21 militants in north waziristan
more than 3,400 migrants rescued at sea in mediterranean	over 2,000 migrants rescued from wooden boats in mediterranean
boston bombing jury to hear closing arguments , begin guilt deliberations	boston bombing jury has question hours into deliberations
germanwings flight 4u9525 co-pilot was once treated for suicidal tendencies	prosecutors : germanwings co-pilot treated for suicidal tendencies
floyd mayweather beats manny pacquiao in unanimous decision	floyd mayweather will fight manny pacquiao in las vegas in may
palestinian factions release demands for gaza ceasefire	palestinians and israel agree gaza ceasefire
7.3 magnitude earthquake hits nepal , close to everest	8.1-magnitude earthquake hits nepal
new un peacekeeping chief named for central african republic	un peacekeepers deploy in central african republic
typhoon to bring rain to philippines	typhoon koppu hits philippines
group : israeli forces detain 11 palestinians overnight , 152 last week	israeli forces arrest 21 palestinians overnight , clash with locals
lewis hamilton takes pole for russian gp	lewis hamilton wins inaugural russian gp
eu ready to impose tougher sanctions on russia	eu to slap new sanctions on russia
un security council hears yemen envoy 's final ...	un security council urges yemen 's houthis to end ...
north korea says talks with south ' all but scrapped'	north korea plans talks with south korea next week
p132b tagged for climate change	marching for climate change
investigators probe deadly russian airliner crash in egypt	investigators 90 % sure bomb downed russian flight in egypt
air strikes kill 18 militants in s . afghanistan	airstrikes , gunfight kill 21 militants in north waziristan
israeli forces arrest 21 palestinians overnight , clash with locals	israeli security forces arrest 8 palestinians in overnight west bank sweeps
13 killed in afgan terror attack	6 killed in afghan capital mosque attack
4 dead , 3 injured in east china road accident	2 dead , 8 injured in central israel traffic accident
us launches strikes around iraq 's haditha dam	us launches new round of air strikes around iraq dam
rev 's early reads : march 2	rev . ' s early reads : sept . 3rd , 2015
markets live : waiting for china data	markets live : china drags
afghan poll rivals sign unity government deal	afghan talks on unity government collapse
nepal quake death toll tops 3,700 , almost 7,000 injured	nepal earthquake death toll tops 5,500 ; 11,440 injured
palestinians , israeli police clash at jerusalem 's al-aqsa	palestinian shot by israeli police in east jerusalem dies
qpr beats aston villa 2-0 in premier league	west ham beats newcastle 2-0 in premier league
paris attacks kill more than 100	nepal quake kills more than 1200
paris attacks : what you need to know	greece 's debt drama : what you need to know
ebola outbreak : keep up to date	ebola outbreak : get up to speed with the latest
tropical storm bill advances toward texas coast	tropical storm dolly heads for mexico 's coast
suspected boko haram suicide bombers in nigeria kill 24	suspected boko haram attacks kill dozens in nigeria
strong earthquake hits northern afghanistan	strong earthquake shakes eastern japan
two killed , four wounded in us school shooting	hospital : teen wounded in us school shooting dies
saudi-led airstrikes hit yemeni capital	saudi-led coalition resumes airstrikes on yemeni capital
hong kong democrats stick to their guns as reform vote looms	hong kong democracy groups to take to streets as key vote looms
the end of the hong kong protests ?	uk ' concern ' over hong kong protests
19 killed in pakistan bus attack	21 killed in tunisia museum gun attack
burkina coup leader given ultimatum	burkina faso coup leader in custody
typhoon mujigae pounds south china , killing nine	typhoon mujigae lands on south china
boston bombing jury to hear closing arguments , begin guilt deliberations	boston bombing jury begins death penalty deliberations
kerry : egypt key in fight against islamic state	mixed progress reported in fight against islamic state
tropical storm fung-wong inundates philippines	tropical storm pounds taiwan , philippines
putin accuses turkey of helping isis , calls for international anti-terror front	putin calls for broad international anti-terror front
new zealand beat south africa to reach world cup final	new zealand and australia meet for perfect rugby world cup final
no police dashcams in ferguson	two officers shot in ferguson
6 afghan police killed in blast	4 afghan soldiers killed in kabul bomb attack
australia holds memorial service for mh17 victims	malaysia to hold memorial service to remember mh17 victims
bali arrest over attempted schoolie rape	somali man arrested after attempted rape
10,000 flee homes as typhoon hits philippines	thousands flee as typhoon hits north philippines
greek pm summoned to brussels for debt deal talks	greeks heading to brussels for crucial talks
russian warplanes strike inside syria	russian roulette in syria
police : indiana suspect hints at more killings	police : indiana man confesses to all 7 killings
thousands of hungarians protest against tax on internet traffic	thousands in hungary march against internet tax
indian police arrest 4 over rape of nun	indian police arrest six over ink attack
4 turkish soldiers wounded in pkk attack	three turkish soldiers killed in pkk attack in southeast
german authorities release al jazeera 's ahmed mansour - al jazeera	german police arrest al jazeera 's ahmed mansour
judge orders kentucky clerk to issue marriage licenses	pope secretly met kentucky clerk over gay marriage licenses
israel , hamas accept egyptian cease-fire proposal	israel , hamas agree to cease-fire
china hushen 300 index futures open higher thursday	china treasury bond futures close higher tuesday
eu plans no new sanctions against russia	eu expands sanction list against russia , ukraine
prosecutors : germanwings co-pilot treated for suicidal tendencies	prosecutor : germanwings co-pilot feared going blind
obama to close historic kenya visit with national address	obama to wind up landmark kenya visit with national address
kentucky clerk jailed over refusing marriage licenses	kentucky clerk kim davis could head back to court for altering marriage licenses
toxic liquor death toll reaches 27	china blast death toll reaches 112
toyota to invest $ 1 billion in ai research	soros ready to invest $ 1 billion in ukraine
iraq : iraq crisis situation report # 24 , 1 august 2015	iraq : iraq crisis situation report no. 22 ( 22 - 28 november 2014 )
islamic state claims beheading of british hostage	islamic state issues video of beheading of us hostage
chinese shares close lower thursday	chinese shares open higher monday
prince william issues appeal to fifa	prince william begins japan tour
japan imposes sanctions on russia over ukraine	eu to prepare possible new sanctions on russia over ukraine
6.6-magnitude earthquake strikes off indonesia	6.0-magnitude quake hits indonesia -- usgs
myanmar ferry capsizes ; 33 dead , at least a dozen missing	myanmar ferry capsizes ; 33 dead
ukraine : ukraine : situation report no. 15 as of 10 october 2014	south sudan : south sudan crisis situation report no. 58 ( as of 16 october 2014 )
egypt has paid back $ 500m to qatar	egypt pays back $ 2.5 billion to qatar
cctv of gunmen in tunisia museum attack	19 killed in tunis museum attack
5.2-magnitude quake hits tibet	7.3-magnitude quake hits devastated nepal
two killed , four wounded in washington state school shooting	third student dies in washington school shooting
riyadh conference : day 1	the riyadh conference on yemen
hong kong stocks open higher	indian stocks close higher
live blog : ukraine in crisis	live blog : iraq in turmoil
6.8-magnitude earthquake strikes chile	6.7 magnitude earthquake strikes western greece : usgs
the views of british labour favourite jeremy corbyn	the lessons of history for jeremy corbyn
critical moment for hong kong protests	uk ' concern ' over hong kong protests
israeli police clash with palestinian protesters at sensitive jerusalem holy site	israel police clash with palestinians in jerusalem
sierra leone 's vice president at home : spokesman	sierra leone vice-president asks us for asylum
nigeria votes in tight presidential election	guineans go to the polls in presidential elections
eurozone leaders thrash out greece bailout deal	german lawmakers to vote on greece bailout deal
egyptian court adjourns trial of al jazeera journalists to march 25	egyptian court sentences 3 al jazeera journalists to 3 years in prison
prince william dons samurai gear on japan tour	prince william of britain arrives in beijing
see the stunning new images of pluto	nasa releases more images of pluto
suicide bomber kills 21 in nigeria	taliban bomb kills 29 in afghanistan
israeli spy jonathan pollard released from u.s. prison after 30 years	israeli spy jonathan pollard released by us
pentagon : u.s. general killed in afghanistan	pentagon confirms us general killed in kabul attack
it 's djokovic again in china open	djokovic and sharapova win china open
japan 's prime minister goes to us to showcase close ties	japan prime minister comes to u.s. for nationwide tour
marco rubio steals the show	teachers steal the show
pope canonizes 2 palestinians	sweden recognizes palestinian state
china lodges protest with u.s. on warship patrol in south china sea	china tells others don 't ' stir up trouble ' in south china sea
iraqi forces retake 2 military bases in anbar	iraqi forces break militant siege of shia town
saudi-led air strikes kill dozens in yemen	saudi-led air strikes in yemen , raids kill more than 90
3 killed , 4 injured in los angeles shootings	five killed in saudi arabia shooting
manchester united 3-1 barcelona	manchester united sign falcao , blind
india beefs up security post blast at pakistan side of wagah border	at least 55 killed in suicide blast on pakistani side of wagah border
micronesia vice president to visit china	vice president of bolivia to visit china
senate to hold one more vote on iran nuclear deal	senate republicans plan vote on iran nuclear deal
islamic state militants raze iraq 's ancient hatra city	islamic state militants kill 40 iraqi troops
islamic state issues video of beheading of us hostage	islamic state posts second propaganda video of uk hostage
hillary clinton pledges to campaign for female democratic candidates	hillary clinton stumps for iowa democrats , and herself
islamic state claims responsibility for killing japanese man in bangladesh	japan says outraged by killing of japanese man in bangladesh
45 killed in pakistan bomb attack	09 : 01 25 killed in somalia hotel attack
chinese shares close higher monday	china treasury bond futures close higher wednesday
hundreds of iranian troops mass in syria	hundreds of ukranian troops retreat across border to russia
ukraine : ukraine : situation report no.17 as of 24 october 2014	south sudan : south sudan crisis situation report no. 58 ( as of 16 october 2014 )
eu tightens sanctions against russia	us , eu expand sanctions on russia
hillary clinton to turn over her private email server	hillary clinton refuses to apologize for using private email system
israel troops kill 2 palestinian suspects in teens ' murder	israel demolishes homes of palestinian suspects in teen killing
us nurse sues over ebola quarantine	nj nurse criticizes her quarantine
typhoon swipes eastern china	typhoon heads for south china
u.s. to screen air passengers from west africa for ebola	pakistan to screen passengers in plans to tackle ebola
burundi police fire tear gas , beat anti-president protesters	police fire tear gas against hong kong protesters
people found locked in a container at harwich port	people found in container ' of indian origin'
iran ends cooperation agreement with pakistan	iran , tajikistan sign cooperation agreement
teenager tests negative for ebola	texas hospital worker tests positive for ebola
7.3-magnitude quake hits devastated nepal	magnitude 7.9 earthquake hits nepal
texas sues over syrian refugees	turkey ' exploits ' syrian refugees
new us sanctions target overseas cyber attackers	china disagrees with u.s. sanctions program on overseas cyber attackers
occupied palestinian territory : israeli forces kill palestinian civilian and wound another one south of nablus	occupied palestinian territory : iof arrest two minors on gaza border and abuse one of them
britain set to approve airstrikes against islamic state in iraq	britain joins fight against islamic state group
us drone strike kills senior is militant	u.s. drone strike kills 4 in nw pakistan
death toll form nepal 's deadly quake soars to 8,413	death toll in nepal earthquake rises over 7,000
world , dallas health worker tests positive for ebola	new york doctor tests positive for ebola
china manufacturing shows signs of stabilizing in october	chinese manufacturing suffers another setback with a slowdown in october
typhoon to bring rain to philippines	typhoon koppu smashes into northern philippines
burkina coup leader wants elections ' soon'	burkina faso coup leader in custody
mediators win nobel peace prize	who will win the 2014 nobel peace prize ?
ten charged over child abuse in manchester	11 held on multiple child sex charges in manchester
5 killed in israeli air strikes in gaza	38 is militants killed in clashes , air strikes in iraq
djokovic claims 6th china open title	djokovic wins italian open
fierce battle rages for kobani	fierce fighting shakes kobani
deadly blast rocks coal mine in east ukraine	12 dead , despite cease-fire in east ukraine
greece bailout uncertainty weighs on global markets	greece concerns drag on asia markets
sinai crash victims arrive in russia	parents of french air-crash victim arrive in taiwan
asian shares follow wall st higher but china fears linger	asia shares swing higher as china nears seven year high
islamic state militants kill 14 iraqi soldiers	islamic state group kills 50 iraqis
rebel weaponry cut back in eastern ukraine	heavy weaponry withdrawal locked in stalemate in eastern ukraine
turkey 's erdogan wondering about russian action in syria	turkey 's erdogan calls for no-fly zone in syria
chinese premier meets armenian president	chinese vice premier meets former u.s. state secretary
four dead as super storm lashes australian east coast	four dead as rain drenches the east coast
rescuers rush to save survivors after mount everest avalanche	nepal quake : survivors tell of everest avalanche horror
australian surfer bitten after landing on shark	australian fishermen lure rare monster shark
palestinian unity key to gaza reconstruction	palestinian authority slams hamas executions
nepal earthquake death toll tops 3,350	nepal quake toll passes 7000
funeral of ian paisley to take place in belfast	funeral of mh17 victim liam sweeney takes place in newcastle
coast guard ends search for 33 missing crew members	queen mary 2 searches for missing crewmember near canada
donald trump doesn 't bow on megyn kelly controversy	donald trump sweeps into iowa on his personal helicopter
roy hodgson promises england will definitely qualify for euro 2016	spain to play england friendly if it qualifies for euro 2016
rooney helps man united beat everton 3-0 in premier league	west ham beats newcastle 2-0 in premier league
hard-line jewish leader shot in jerusalem	israeli leader urges calm in jerusalem
waba emerges new nlc president	waiting for the next president
backstage moves intensify as fight against islamic state widens	mixed progress reported in fight against islamic state
hong kong stocks open higher	hong kong shares finish lower
israel police clash with palestinians at jerusalem holy site	israeli police shoot , kill palestinian woman in hebron
egypt : ipi urges release of al jazeera journalist arrested in berlin	egypt sentences al jazeera journalists to jail
iran , six powers demand mutual concessions in tense nuclear talks	iran says world powers are divided and backtracking in nuclear talks
japan economy contracted 1.2 percent in april-june quarter	us economy contracts in first quarter
your letters : your letters hong kong protects domestic helpers	your letters : your letters show mercy , mr . president
occupied palestinian territory : israeli forces continue to shed palestinian blood in opt	occupied palestinian territory : israel warns on security as gaza truce talks resume
contributing op-ed writer : vladimir putin 's guide to world history	contributing op-ed writer : the roberts court 's reality check
car bomb attacks kill 57 people in iraq : police	ied attack kills two people in iraq 's baghdad
5 us airstrikes target islamic state fighters	kurds see turkey impeding islamic state fight
tunisia museum attackers ' trained ' in libya	tunisia museum attack : at least 17 killed , 3 at large
typhoon koppu smashes into northern philippines	strong typhoon lashes northeast philippines , two dead
greek finance minister says some election vows can be put off	greek finance minister says bailout deal will take country forward
africa : china in support of africa 's development	china is immensely important partner in africa 's development
south carolina removes confederate flag from state capitol	era ends as south carolina lowers confederate flag
french doctor sick with ebola in liberia	us doctor infected with ebola in stable condition
erdogan wins turkish presidential election in turkey	togo opposition rejects presidential election results
markets live : waiting for china data	markets live : resources in retreat
us stocks climb higher in early trading	us stocks open modestly higher in quiet trading
federal money starts to flow for syrian refugees	angelina jolie makes powerful plea for syrian refugees
occupied palestinian territory : hamas demands israel free 54 palestinians before new talks	occupied palestinian territory : eu warns gaza violence could return in ' months'
germany urges its partners , iran to grab nuclear deal	german press agency hails zarif as architect of iran nuclear deal
iran says new sanctions will make nuclear agreement difficult	iran wants sanctions lifted before nuclear deal : official
missing ashya : arrest warrant issued for parents	arrest warrant issued for pistorius
chad kills 200 boko haram militants in nigeria : report	boko haram militants storm town in ne nigeria
occupied palestinian territory : israeli troops kill palestinian who stabbed civilian in west bank : army	occupied palestinian territory : palestinian killed in clash with israel forces in jenin : medics
second american aid worker with ebola arrives in us	american doctor stricken with ebola is improving
libya : un orders investigation into libya rights abuses	india 's top court orders investigation into job scam , deaths
taiwan coast guard launches new ships as south china sea tensions rise	chinese military reaches out amid south china sea tensions
holder asks for federal autopsy on missouri teen	federal autopsy ordered in missouri teen 's death
burundi police fire tear gas at protesters	montenegrin police fire teargas to disperse opposition
us stocks-wall st opens higher ahead of fed statement	us stocks-wall st lower as investors await word from yellen
hawaii preps for first hurricane in 22 years	hawaii braces as hurricanes close in
ebola patient not asked about travel	ebola patient in texas dies says us hospital
israeli air strike targets hamas in response to rocket attack	israeli army ordered to resume strikes against targets in gaza after rocket attacks
hong kong protesters on hunger strike after violent clashes	hong kong protesters demand leung chun-ying resigns as city leader
south korea declares de facto end to mers outbreak	north korea defectors swim across sea border to south korea
egypt : ipi urges release of al jazeera journalist arrested in berlin	egyptian court sentences 3 al jazeera journalists to 3 years in prison
liberia discharges last ebola patient	liberia : runaway ebola patients found
terrorists attack university in kenya	terrorism attack feared ' within days'
israel and hamas agree new truce	israel and hamas to resume indirect talks on october 27
china struggles to halt stock market slide	china 's stock market meltdown
pope francis faces new challenge in cuba	pope francis addresses congress
us , iran see progress in nuclear talks , but ways to go	european powers , iran make little progress in nuclear talks
nepal earthquake death toll surpasses 7,000	death toll in nepal earthquake tops 8,000
ebola health workers go on strike in sierra leona	ebola cases rise sharply in western sierra leone
israel , hamas agree to 72-hour truce	israel and palestinians reportedly agree to 72-hour ceasefire
iran nuclear talks enter their final day	iran nuclear deal outline - is the marathon finally over ?
hungarian fm to visit china	hungarian state still hungry
bomb blasts at hindu temple in bangladesh , 10 injured	bomb attacks in bangladesh leave 1 dead , over 100 injured
nff congress sues for peace	hong kong protesters mass for peace rally
obama : ebola outbreak also a security threat	obama : ebola threat to ' regional , global security'
baltimore police enforce curfew following riots	baltimore mayor lifts curfew 6 days after riots
kerry : egypt key in fight against islamic state	arab league to back iraqi , us campaign against islamic state
iran appoints first woman ambassador since revolution	iran summons pakistani ambassador over border killings
it 's jason day and everyone else at bmw championship	jason day holds two-shot lead over jordan spieth at pga championship
jeremy clarkson 's future on top gear thrown into further doubt	jeremy clarkson 's road to ruin on top gear
at least 30 fighters killed in syrian city of kobani	at least eight afghan soldiers killed in ' friendly fire ' incident
european commission proceedings against malta ...	european tax meeting in malta
malala seeks to come pakistan , join politics	pm nawaz sees polio-free pakistan in six months
ashya 's parents arrive for extradition hearing	ashya king 's parents freed from jail in spain
hong kong police arrest 9 , seize explosive materials	hong kong police arrest dozens of student protesters
nigeria admits slow response in ebola case	us ramps up response to ebola crisis
idf jeep overturns , kills palestinian in west bank clashes	israel detains 14 palestinians in west bank , summons man
voting begins in fifa presidential elections	bribery scandal shakes up brazil 's presidential elections
turkey identifies suspect in suicide attack	four civilians killed in kabul suicide attack
gunmen kill 8 laborers in southwest pakistan	u.s. drone kills eight in northwest pakistan
thousands cross austria-hungary border	thousands of russians stranded abroad
russian military trucks on ship bound for syria	new russian military might on full display in syria
israel : we didn 't spy on iran nuclear talks	'yes or no ' time in iran nuclear talks
why hong kong 's protests are a big deal	hong kong protests see weird , wonderful scenes
strong 6.0-magnitude quake hits northern california	4.1-magnitude quake jolts sw china
rouhani felicitates ghana president	afghanistan inaugurates new president
at least 17 killed , 400 injured in massive tianjin blasts	five killed , 40 injured in suicide attack in lahore
kranjcar leaves it late to rescue qpr against moses-inspired stoke	harry kane leaves it late to rescue a point for tottenham hotspur
liberia president describes heavy cost of ebola	nigerian president replaces military 's top brass
6.0-magnitude quake hits indonesia -- usgs	6.7 magnitude earthquake strikes western greece : usgs
iran nuclear talks extended for another day	iran nuclear talks : comprehensive deal ' to be announced as early as monday'
australia beat ireland at stormont	australia berates israel over ' shocking ' attacks
john kerry urges talks to ease china sea tensions	kerry : israel , jordan working to ease holy site tensions
oscar pistorius sentenced to 5 years in prison	'bookkeeper of auschwitz ' sentenced to four years in prison
greece nears bailout deal	greece imf payment missed as bailout expires
fm congratulates erdogan on election victory	obama congratulates turkish people over election
hong kong protesters pull back from some areas	hong kong student leaders mull protest retreat
pro-palestinian activists march to un headquarters	pro-palestinian activists prepare flotilla to break gaza blockade
hong kong protests escalate	hong kong protests turn festive after tear gas chaos
islamic state militants kill 15 iraqi police near syrian border	an islamic state militant carries out a suicide attack in syria 's aleppo
5 killed in kurdish militant attacks in southeast turkey	ten turkish policemen killed in an attack east of turkey
brazil presidential candidate dies in plane crash	ivory coast presidential candidates recognises ouattara victory
china , africa to strength health cooperation	chinese vice premier calls for stronger china-eu climate cooperation
oil prices rise after chinese trade data	oil prices down in asian trade
benzema faces possible charges in sex-tape case	menendez faces possible corruption charges
us senate votes to advance iran nuclear review bill	us scientists praise iran nuclear deal
islamic state smashes iraqi history with sledgehammers	islamic state seizes iraqi army base , pm to send in shi 'ite fighters
china warns against ' immoral ' art	bp warns against russia sanctions
all 224 dead in russian airliner mystery crash	heat flash detected at time of russian airliner crash
merkel : taking in migrants is right thing to do	german immigration official steps down
donald trump ebola tweet sparks outcry	donald trump to unveil tax plan monday
ashley madison users facing extortion threats	ashley madison cheaters exposed
euro ministers set to launch greek bailout , wooing imf on debt	eurozone ministers approve 86-bln-euro greek bailout deal
islamic state fighters and force allied with tripoli clash in central libya	islamic state fighters seize syrian air base
u.s. involved in seven air strikes on islamic state targets	coalition airstrikes pound islamic state stronghold in syria
pope francis urges congress to embrace migrants	pope francis begins tour of cuba and us
govt. to hold talks with ftii students	cameron to hold talks with sturgeon on uk future
3 indian officials suspended after lynching of rape suspect	india to free five gang rape suspects
li na to announce retirement	us senator ted cruz to announce presidential bid
gunners fire but fail to advance in champions league	epl clubs out to avoid champions league woes
five killed , 40 injured in suicide attack in lahore	six killed , 50 injured as train derails near rae bareli
islamic state destroys ancient shrines in syria 's palmyra city	islamic state group seizes villages in syria
highway patrol take over policing ferguson and hug protesters	two police officers shot in ferguson amid race protests
469 israelis petition spain to recognize a palestine state	british parliament to debate motion to recognize palestine
scientists prove there is water on mars	has nasa discovered water on mars ?
cameron in beirut over refugee crisis	cameron way behind curve on refugees
iranian president praises nuclear deal	iran arrests several spies near nuclear plant
boko haram disrupts nigerian elections	press awash with nigeria \ ' s general elections
china 's march non-manufacturing pmi dips	china 's manufacturing improves in september
foreign office names repatriated tunisia victims	silence to remember tunisia victims
fifa chief sepp blatter now ' in the crosshairs'	fifa president sepp blatter facing suspensions
south korea regrets north 's refusal of talks	south korea reports 14th mers death , 12 new cases
iraq launches attack to retake tikrit from is	iraqi forces fail to recapture tikrit from militants again
chinese president holds talks with angolan president	chinese president declares youth olympic games open
7 chinese confirmed dead in bangkok blast	thailand arrests second foreign suspect in bangkok blast probe
plane crash site search called off for the night	tour de france pack sets off for stage 15
obama to get briefing on military plan against islamic state	marine death is 1st in campaign against islamic state
four us marines killed in attack on military facilities	four us marines and gunman killed in ' act of terrorism ' in tennessee
vote to allow palestine flag to fly at un headquarters	general assembly vote lets palestinians fly flag at u.n. headquarters
editors from around the world urge turkey to protect media	media freedom at stake as turkey fights rebels
russian forces spotted in donetsk and luhansk , says ukrainian colonel	church should not fear change , pope says at synod close
agency releases its report of train disaster in quebec	qatar rejects rights group report on ' rampant ' labor abuse
stocks rise as china fears ease ; oil recovers	asia shares swing higher as china nears seven year high
cameron urges more action on migrants crisis after calais chaos	camerwoman fired for tripping up fleeing migrants
obama queries turnbull over china port deal	spanish bulls gore seven to death
china 's generous 1mdb bid seen reaping it big returns in malaysia	china keeps an eye on visiting tiger freed by russian president
khaleda zia granted bail in graft cases	oliseh appointed as nigeria coach
historic nuclear deal reached ; iran no longer under sanction	iran optimistic on nuclear deal , us much less so
un chief appeals for calm in jerusalem	gaza aid appeal raises almost £ 1m
global markets brace for short-term hit after paris attacks	india thwarts coal heat at paris meet
british singer cliff richard interviewed by police	british radical preacher choudary granted bail
greek banks reopen as government eyes return to normalcy	lebanon 's former pm returns after 3-year absence
asian markets up after fed minutes	investors burying their heads in the sand ?
hezbollah targets qaeda gathering along border with syria	belarus tightens security along the border with ukraine
south korea reports seven new mers cases	south korean woman in contact with mers patient dies
hawks equal franchise wins record	pope francis in america
metro police to get fresh training in crowd handling at police academy	baltimore police enforce third night of curfew
one north korean defector wants to return home - and is forbidden	north korea defectors swim across sea border to south korea
france pushes u.n. to support fight against islamic state	private sector urged to join fight against malaria
iran fm arrives in najaf	chris brown arrives in china
us demands rescue of asian migrants adrift at sea	over 1,800 migrants rescued from six boats adrift off libya
hong kong protests weighing on global markets	hong kong protest leaders suspend planned vote
iran : messages exchanged with us over battle against islamic state	marine death is 1st in campaign against islamic state
saudi-led air strikes in yemen , raids kill more than 90	saudi-led coalition pounds yemen rebel camps , lashes out at iran
obama calls for international front against is	obama vows to save iraqis stranded on mountain
islamic state raises flag on eastern side of kobani	iran : police plane crashes , leaving seven people dead
1 american killed , 1 hurt in saudi gas station shooting	nation 1 killed , 4 wounded in zombicon shooting
us stocks open higher as investors wait on fed	tokyo stocks open higher following wall st. gains
u.s. military says it conducts airstrikes against is in syria , iraq	observatory says russian air strikes kill 45 in syria
who abandoned 3 boeing planes at the airport ?	police abandon posts in lesotho , fear for lives
uk : jets doing reconnaissance , ready to strike in iraq	france begins reconnaissance flights over iraq
north korea to put us citizen on trial	n korea hit with new us sanctions
obama tries to sell plan to defeat islamic state	lebanon pulled into war with islamic state group
iraqi troops , militias repel is attacks in anbar province	20 palestinians injured in iof attacks in jenin
seven killed as new york train hits vehicle	at least 12 killed as shebab attack somalia hotel
thousands protest government policy in nazareth , call for palestinian state	hong kong protests : china government official says apec summit should not be affected
parliament reappoints libyan prime minister	thai army ruler named prime minister
spain ebola patient at ' serious risk ' of dying	hiding ebola patients now illegal
6 injured as blast hits train in south pakistan	power cut hits southern pakistan
poroshenko : association agreement will be ratified in september	poroshenko raises decentralisation referendum but rebels reject
netanyahu bars ministers from visiting jerusalem holy site	netanyahu warns of militant islamist threat
hong kong officials resume work as protests thin	hong kong student leaders mull protest retreat
us man convicted over web suicides	zim excited over president xi visit
estimated 6,500 injured in deck collapses since 2003	2 killed , 450 injured in pakistan police clashes
britain beat australia for first time in 17 years	indexes flat ; on track for best month in four years
scotland decides to stop funding queen via scottish crown estate	is claims to hold chinese and norwegian hostages
russia denounces arrival of u.s. military trainers in ukraine	icrc confirms its participation in consultations on ukraine
ebola uk : nhs staff ' panicked ' after suspected ebola cases	uk says investigating 2 suspected mers cases
u.s. senator calls for soccer corruption report to be made public	un sec-gen calls for irans contribution to lebanon security
'many dead ' in egypt plane crash	at least 39 killed in iranian plane crash
french fm : still no guarantees on verifiable iran nuclear deal	u.n. security council endorses iran nuclear deal
pakistan rejects india 's claim on kashmir	pakistan protests ceasefire violations by india
passenger jet crashes near tehran airport	nasa 's messenger probe crashes into mercury making giant crater
uk leader signals support for airstrikes on is in syria	why cyprus backs cameron 's push for uk air strikes in syria
nepal earthquake death toll rises sharply amid aftershocks	japan typhoon death toll rises to six : report
philippines , canada pledge to further boost relations	philippines saves 100 after ferry sinks
migrants storm budapest train station	hungary reopens budapest train station , triggering new standoff
israeli ' cult ' leader faces prison for sexual offences	israel , hamas to discuss prisoner exchange
contribute to nation building - cyril	tunisia contributes to international effort to rebuild gaza
nigeria releases detained al-jazeera journalists : tv	iran welcomes european rail tourists
safety fears over chinese chemical blasts in tianjin	president xi visits chinese youth olympic delegation in nanjing
israel bars palestinians from jerusalem 's old city	two-state solution between palestinians , israel pie in sky
russia calls the shots	russians protest against putin
british woman dies in australia crash	british investments in egypt worth $ 26m
german envoy : nations ready to move beyond iran sanctions	german coalition politicians break ranks on greek wwii reparations
president responds to girl 's euthanasia plea	president : iran to continue enrichment
more chinese relief aid sent to myanmar flood victims	chelsea , mourinho apologise to racism victim
'life on planet at stake ' , france warns as climate ministers meet	four reasons for optimism as climate ministers take over talks
will ' warrior king ' take out election ?	chicago mayor in run-off election
how much do you know about secret service ?	lawmakers from both sides express outrage at secret service
burundi says demos against president 's candidacy are over	burundi police fire tear gas in protest against president
alexander lukashenko wins belarus presidential race	poland votes duda in presidential elections
putin takes on syria	britain launches airstrikes on isis in syria
turkey 's election : tyrant or steadying hand ?	turkey 's ruling party loses parliamentary majority
man in serious condition after ballyfermot shooting	msf wants independent inquiry after fatal bombing
israel soldiers , palestinians clash on ' nakba ' day .	israeli forces shoot , injure 82 palestinians in gaza , west bank nov . 27 , 2015
naacp leader lying about being black , mother says	nda toes upa line on disclosing info on black money
russia sues germany over mulino training ground contract disruption	russia ready to return over 20 ukrainian ships based in crimea to ukraine
muhammadu buhari takes over nigeria in crisis	hungary authorises government to use army in migration crisis
us stocks rise at midday ahead of fed statement	u.s. stock futures slump after china market selloff resumes
hillary clinton delivers remarks in south carolina	hillary clinton : us should lead on clean energy
soldiers killed in taliban attack in kabul	at least 27 killed in car bombings , militia attacks north of baghdad
ferguson unrest : protest marks two weeks since police shooting	ferguson teen brown autopsy reveals six gunshots
hungary drops controversial border ' transit zone ' plan for migrants	hungarian tv journalist fired for tripping up fleeing migrants
n . korea agrees to talks with south	johor crowns its fifth sultan
bill clinton appears in virtual-reality movie on africa	clinton makes pitch to working americans
fears australian extremism could escalate	australia beat scotland in thriller
somalia car bomb kills 7 near presidential palace : police	poland kicks off presidential election
us , allies say conduct 15 air strikes in syria and iraq	u.s.-led airstrikes on isis in syria : what you need to know
drone footage of manchester fire	aguero strike sinks 10-man manchester united
team seeks anyone who encountered ebola patient	liberia to prosecute man who brought ebola to us
2 alleged npa rebels killed in bukidnon	several killed in sweden pub shooting
youngest chinese hacker is a teenager	france 's right-wing parties take the senate
mob throws stones at pakistan convoy	pope francis canonizes two palestinian women
china , africa to strength health cooperation	police chief calls for deepening mainland-hk cooperation
death toll rises to 19 on malaysia 's mount kinabalu after quake : official	historic tower collapses in kathmandu after quake
top iranian general , hezbollah lead iraq ground war	iranian general is killed in syria advising military
bangladeshi jamaat leader loses appeal against hanging	bangladeshi mourners pay tribute to slain blogger
hong kong police arrest dozens of student protesters	hong kong tensions rise as police use pepper spray on protesters arrest 45
michael brown shooting : family lawyer suggests 18-year-old was ' surrendering'	michael brown 's family suing cop and ferguson
palace up to sixth after victory at watford	late goals give man city victory at villa
iran , a large important partner for russia : novak	iran reiterates support for iraq , syria
global pressure on us to loosen oil exports ban	iran ready to resume oil exports to egypt
us and iran positive after nuclear talks	hong kong protests turn festive after tear gas chaos
taiwan 's president charters plane to pay respects to lee	poland president loses to challenger
two palestinians die in attacks on israelis ahead of kerry visit	palestinian official slams israel 's stone-throwing bill
minister urges malayalis in yemen to return	minister to raise pakistan case at climate conference
china home prices rise for second month in june	china approves iphone 6 after security assurances
egypt court declares palestinian movement hamas ' terrorist'	wave of unrest leaves palestinian president with no good choices
thomas cook accused of putting costs before customers	university of florida frat accused of spitting on wounded war veterans
female soldier strip-searches 2 palestinian women in beit ummar	three males held over series of stabbings in temple bar area
australian grand prix : lewis hamilton takes the honours in style	australia bins standalone coding for kids in schools course
obama secures key vote to protect iran nuclear deal in u.s. congress	lebanese politician urges arab countries to welcome nuclear deal
narendra modi ' photoshopped ' image of chennai floods visit goes viral	pm narendra modi speaks of non-discrimination and equality
myanmar education activists arrested	myanmar discovers case suspected of ebola
ted cruz : donald trump won 't be gop nominee	donald trump to unveil tax plan monday
glasgow votes ' yes ' to scottish independence	brexit will lead to clamour for scottish independence , says sturgeon
mourners march to commemorate french bus crash victims	tears in barcelona at funeral for germanwings crash victim
un chief welcomes peaceful presidential elections in guinea	un chief condemns attack against peacekeepers in mali
netanyahu says will use ' all means ' to end palestinian violence	germany says wants to keep close ties with poland
starbucks encourages baristas to talk race	kentucky senate rivals hold solitary debate
obama struggles to soothe saudi fears as iran talks resume	myanmar struggles to finalize voter lists for sunday polls
7 foreigners , 1 tunisian dead in museum shooting attack	u.s. government scrambles to deal with massive hacking attack
pakistan executions draw international ire	pakistan protests ceasefire violations by india
philippines confirms nurse infected with mers	hawaii preps for first hurricane in 22 years
brazil to elect president today in run-off vote	tanzania awaits tense presidential poll result
obama : ' no excuse ' for violence	mers : no cause for alarm in phl
obama begins meeting with raul castro in panama	ag holder meeting with michael brown 's parents
liberty president calls for an armed christian campus	liberia 's president orders civil servants to stay home amid ebola crisis
israeli defense minister in us after spat over kerry remarks	italy 's cabinet wins key confidence vote in senate over labor reform
search resumes for missing in brazil mine mudslide	search for indonesia 's missing chopper underway
tony blair denies saying miliband can 't win	britain 's tony blair resigns as u.n. middle east envoy
north korea starts huge military parade	envoy : north korea will pursue ' defensive ' nuclear program
south korea declares end to mers outbreak	north korea delegation meets with south korean officials
us pledges more military support to somalia	cui : us patrol serious political , military provocation
pranab stresses need to strive for peace by nations	wto : india regrets action of developed nations
nuns ' mission in pakistan	free speech activist killed in pakistan
philippines seeks us help in stopping china land reclamation	philippines : erc to build 10 schools in philippine typhoon-ravaged areas
eastern europe turns down refugee plan	japan restarts nuclear plant
fireman killed in south china	over 80 militants killed in khyber agency
asian stocks mostly down on weak data , commodity prices	us stocks open mostly lower as earnings disappoint
volkswagen skids into red in wake of pollution scandal	volkswagen 's " gesture of goodwill " to diesel owners
two australians killed in kenya after bus crashed into river	permalink to two killed in germany train accident
6 killed in school stampede in china	21 killed in tunisia museum gun attack
france shuts mosque , arrests man in crackdown after attacks	security tightened at new delhi churches after attacks
syrian refugees not welcome in 30 u.s. states	liberia to become christian state
us vice president 's son dies	vice president of congo elections commission resigns
train rams suv , killing 13 in eastern india	head-on collision kills 7 in east china
russian plane reportedly crashes in egypt	pilot killed as us jet crashes in england
du preez drives springboks into world cup semi-finals	jibes fly before australia-nz rugby world cup final
u.s.-led coalition conducts 25 air strikes against islamic state militants	obama rallies coalition commanders against is jihadists
british parliament backs airstrikes against isis in iraq	us military releases footage of air strikes on isis targets in iraq and syria
iraq launches operation to retake tikrit from islamic state	obama vows to hit islamic state
amit jain named president of uber india	beau biden , son of vice president , dies of brain cancer
three somalis killed in attack on un convoy in capital	dozens killed after air strikes in yemen capital
japan continues to insist on its rights for senkaku islands	gov 't : sanctions on russia don 't hit paks plans
hundreds reportedly attend burial for danish gunman	russian market : great export potentialities for tunisia
severe gales as storm clodagh hits britain	merkel pledges nato solidarity with latvia
netanyahu looks for alternative approaches to peace talks	netanyahu forms new government just ahead of deadline
strong quake kills 367 in southern china	australian father charged with abusing surrogate twins
italy warns of libya threat as pressure for action grows	mainland to lift entry-permit requirement for taiwan residents
belarus tightens security along the border with ukraine	malls in paris , london under tight security after shabab threat
pistorius lashes out ahead of verdict	jp bullish ahead of triangular
nurse with ebola appears on camera before leaving dallas hospital	first ebola case diagnosed in us after man who flew in from liberia falls ill
children among bombardment victims in syria	girl bombs market in nigeria
nato shunned as france calls on eu to destroy islamic state	texas man arrested , accused of helping friend travel overseas to join islamic state
dozens of egyptians hostages taken by libyan terrorists as revenge for airstrikes	egyptian boat crash death toll rises as more bodies found in nile
president heading to bahrain	president xi : china to continue help to fight ebola
venezuela 's president concedes defeat	venezuela tightens visa rules on america
u.s. stocks open lower after rally	us stocks end rocky week with a surge ; nike gains
us surveillance powers set to lapse after senate vote	iceland lowers volcano alert to orange
china , india vow to further bilateral ties	china scrambles to reassure jittery stock traders
tsarnaev jury to begin deliberations	musharraf 's party to contest pakistan 's local elections
gunmen kill 20 laborers in sw pakistan : officials	suicide attack , bomb blast in pakistan kill 10
china to put 81-year-old writer on trial : lawyer	china cut yuan rate more than 1 % against dollar
boko haram : traders commend fg / boko haram ceasefire	adam chandler : a hollow ukrainian cease-fire
ukraine city readies for rebel advance	ukraine minister says ' no threat ' from nuclear plant accident
funeral of ian paisley to take place in belfast	kerry calls for united front to tackle islamic state
obama is right : africa deserves better leadership	obama waiting for midterm to name attorney general
man , 20 , kills 13 in oregon college shooting	4 killed in okla. crash involving college softball team
german minister lands in iran with trade team	yemen to name new pm in deal with shiite rebels
felline pips aussie matthews in basque sprint finish	hamilton wins russian gp as rosberg fails to finish
attack on canadian parliament : soldier , shooter killed	tunisian army chief resigns after soldiers killed
turkey slams russian missile launcher ' provocation'	turkey urges russia not to escalate tension in syria
obama addresses plight of christians in mideast	u.s. rebukes israel 's victorious netanyahu on mideast policy
us is most popular destination for chinese travelers	nusra demands compensation , aid for release of soldiers
does biden have what it takes to compete in new hampshire ?	police called to reports of helicopter in the sea
'framework ' for final deal reached at iran nuclear talks	seize the moment for breakthrough in iran nuclear talks
spain won 't commit to taking in more migrants	turkey votes in one of most crucial elections in years
kranjcar leaves it late to rescue qpr against moses-inspired stoke	iran jails academic for crimes against regime
kerry aims to calm south china sea tensions	iraqi kurds say islamic state used chlorine bomb
ebola outbreak an ' international emergency ' - world health organisation	ebola outbreak deaths exceed 4,000 - who
nigeria reaches deal with boko haram over abducted girls : source	scores dead after boko haram bomb attack in nigeria
putin spokesman : doping charges appear unfounded	the latest on severe weather : 1 dead in texas after tornado
six dead , 33 injured in china firework plant explosion	2 killed , 5 injured in helicopter crash in afghan bamyan province
pakistan will not allow ngos working against national interest : nisar	tianjin china blast : rescuers working against time
new video shows us police officers beating mentally-ill man	new york police officer critically wounded in hatchet attack
'hundreds arrested ' in burundi amid political unrest	burundi : small groups of protestors , police clash in burundi capital : witnesses
all nine on board die in alaska crash of excursion plane	lonmin expects full-year underlying cash costs below guidance
