a cat standing on tree branches .	a black and white cat is high up on tree branches .
two green and white trains sitting on the tracks .	two green and white trains on tracks .
a small white cat with glowing eyes standing underneath a chair .	a white cat stands on the floor .
a large boat in the water at the marina .	a large boat on the sea .
a bus driving in a street .	red double decker bus driving down street .
the lamb is looking at the camera .	a small bird standing on a log at the waters edge .
a passenger train waiting in a station .	a passenger train sits in the station .
a woman at a dinner table writing on her notebook .	woman at table busy with something .
an apple computer sitting on the floor .	a macintosh computer sitting on the floor .
a close-up of a brown horse 's head .	a side view of a horse 's head .
a group of people eat at a table outside .	group of elderly people sitting around a table .
the curious boys look in the shed .	two small boys in a woody area looking at a shed .
a jockey riding a horse .	a jockey riding a horse in a pen .
a bull standing in the field .	a brown horse stands in a lush green field .
the man is riding a motorcycle down the road .	a man is riding a red motorcycle on the road .
a woman riding a brown horse .	a young girl riding a brown horse .
the black and white cows pause in front of the gate .	a black cow and a brown cow stands in a plain in front of an uprooted tree .
a kid jumping a ledge with a bike .	a black and white cat playing with a blanket .
a moped in front of steps of ruins .	a moped in front of ruins .
a man sleeps with a baby in his lap .	a man asleep in a chair holding a baby .
a group of four people in a dinner having cake .	four people eating dessert around a table .
a black dog standing in front of yellow flowers .	a black dog standing in a field .
close up of a bottle of water .	a close up view of a bottle of water .
a close up of a brown faced cat .	a close up of an ostrich face .
sheep standing in afield .	a sheep grazing in a field .
a group of people eat at a table outside .	a group of elderly people pose around a dining table .
a longed-haired cat with it 's eyes closed .	a close up of a cat with its eyes closed .
a woman in a gray shirt smiles for the camera while the woman behind her makes a face .	a woman with a surprised look on her face is holding a smiling woman from behind .
a silver and blue amtrak train on the tracks near a small train station .	a small white car parked at the gas station .
a person in a blue shirt reclines near a coffee table and television .	a person stands on the motorcycle seat and pops a wheelie .
two cats are looking at a window .	a white cat looking out of a window .
a black and white photo of a woman showing a horse .	a black and white photo of cows in their stalls .
a dark brown horse standing in a field .	a brown horse stands in a lush green field .
a pitched tent with a horse in the background .	a black and white lamb with other lambs in the background .
older man wearing beret with mountains in background .	a sheep in the morning mist with trees in the background .
the cows feed in the trough .	the brown and white cows are eating in the trough .
a small red and gray bird perched amongst the bare branches of a tree .	a red and brown bird is perched on branches .
a person wearing a helmet rides a bike near a white structure .	a girl wearing black shorts and boots is standing next to a blue motorcycle .
a group of people sitting around a table with food on it .	a group of people sit around a table with food and beer .
a black and wood colored dining room set in a small apartment .	black and brown table in living room setting .
a brown horse stands in a lush green field .	a brown horse in a green field .
a black and white cow in hay .	a black and white cow in a pen with hay .
an elderly woman stands in a kitchen with two cats at her feet .	the old lady is standing in the kitchen with two cats at her feet .
a school bus is driving uphill on a rural road .	a race care driving along a dirt road .
a bag of cotton in front of a couch .	calico cat sitting on step in front of a door .
camouflage airplane sitting on grassy field .	a camouflaged plane sitting on the green grass .
three young women standing in a room together .	two indian women with two indian girls near the water .
red double decker bus driving through the streets .	double decker passenger bus driving with traffic .
a white sheep on a hillside looking at the camera .	the skinny cows are standing on the grass .
a group of sheep in a field .	a group of horses grazing in a field .
a close-up , distorted photo of an empty glass coke bottle .	a close-up picture of a desk with a computer and papers on it .
very crowded office desk with computer monitor on .	messy computer desk with two monitors .
a man sitting in a cluttered room .	a man lies in a bed in a cluttered room .
two white cows in a green pasture .	the tan horse is in the pasture .
a man with a bicycle at a coffee house .	man walking bicycle to patio of a coffee shop .
black cow walking under trees in pasture .	cow walking under the tree in a pasture .
two horses standing in a field with trees in the background .	a black and white bird on a body of water with grass in the background .
two people sitting at a table at a restaurant .	four people sitting at a table .
red double decker bus driving down a street .	a red two story bus driving along the street .
a smiling woman with a beer sitting outside with another smiling woman .	two women sitting outside laughing .
a bird holding on to a metal gate .	a multi-colored bird clings to a wire fence .
the skinny cows are standing on the grass .	the white ducks are standing on the ground .
a women laying across two men sitting on a sofa .	a man and two women smiling at the camera while sitting on a blue sofa .
a woman with a big necklace .	a young woman with a black top and a necklace .
brown cow with horns standing in a field .	brown horse standing in middle of grassy field .
a cruise liner docked at the shoreline .	a cruise ship docked at shore .
black and white cat lying under bush .	the black and white cat with yellow eyes lounges in the dirt .
brown and white cow standing in grass at side of road .	a brown and white cow standing in a grassy area with trees behind .
a small dog looking up at the camera while standing on grass .	a man and women smiling at the camera while standing in a kitchen .
a tan calf with a yellow tag on his left ear looking at the camera .	a man with glasses and two plastic bottles in the foreground .
black and white photo of couch with purse at one end .	a black and white photo of a cow under a tree .
the lamb is looking at the camera .	a cat looking at the camera .
a red double decker bus on a crowded street .	a double decker bus on a city street .
a jockey riding a horse in a pen .	a jockey rides a horse at a gallop .
two men on boat floating on the water .	large green boat floating on water.l.
this is a rear view of a chevrolet sports car .	the rear view of a red chevrolet concept car .
a person wearing a helmet rides a bike near a white structure .	a person wearing a bike helmet rides a bike on a path through trees .
a black and white photo of an old train station .	a black and white photo of a motorcycle laying on the ground .
a grey and white tabby cat is sleeping on purple fabric .	black and white cat sleeping on a brown tarp .
a black and white cat is high up on tree branches .	black and white lamb with tag in right ear .
a woman holding a small baby .	a smiling woman holding a small baby .
group of horses grazing in grassy field .	a group of horses grazing in a field .
three men are sitting down at a table that has drinks on it .	three men sitting at the table with beer and food .
two people dressed in white standing on a grass field .	a person is standing underneath an overpass near a highway .
a young blonde girl wearing a helmet sits with a red bicycle behind her .	a young girl wearing a bike helmet with a bicycle in the background .
an orange tabby cat sleeping on the sofa .	a man is watching tv on the foot of his bed .
two eagles perched on a branch .	two bald eagles perched on a branch .
a striped cat laying down on a bag of cat litter .	domestic cat laying on back of cat litter .
blue couch and twin bed in a living room .	blue couch in room with sun shining in .
a man and small child in a living room posing for the camera .	a man and woman are posing for the camera .
a home office with three computer monitors and other equipment on a desk .	room with several computer monitors .
five birds stand on the snow .	several cardinals stand in the snow .
the udders of a dairy cow that is standing in a pasture near a large building .	the black and brown cow is standing on the green grass .
a black vehicle parked with a vies of low-lying mountains .	a black car parked in the dirt out in the country .
a passenger train in the snow .	a passenger train waiting in a station .
the black bird is sitting on the ground .	a blackbird sitting on the ground .
the black and white bull is looking at the camera .	a black and white dog looking at the camera .
a woman posing by a pillar with a u2 sign .	a woman is standing by a pillar where " u2 " is written .
a young girl riding a white and grey horse .	a young blonde girl in riding gear sits on top of a gray and white horse .
a black and white sheep is walking next to a white sheep .	little black and white calf with a tag on its ear .
a living room with a dining table in the background .	a boy doing a wheelie on a plank with the beach in the background .
the dining room table gets some afternoon sun .	dining room with wooden dining table set with playmates .
a red moped parked on a sidewalk in front of graffiti .	the red scooter is sitting on the street in front of the building .
the seagull is floating on the water .	a little bird floating in the water .
the flock of sheep are spread out in the field .	a white cat stands on the floor .
two dogs and one cat sitting on couch .	two dogs and a cat resting on a couch .
a black dog stands next to materials at a construction site .	an asian toddler girl sits next to a pot of flowers on a marble post .
a woman posing in front of an apartment building in the snow .	a woman stands in front of a building in the snow .
one asian and one occasion woman in glasses smiling with their thumbs up .	two women are posing for the camera and giving the thumbs up sign .
a black train moves down the tracks .	a mostly black train on a track .
five cows are grazing beside the road .	several sheep grazing in the field .
two mountain goats grazing in front of an alpine lake .	two animals grazing next to a mountain , and a body of water .
black and white cows behind a fence .	two black and white cows behind a metal gate against a partly cloudy blue sky .
a passenger train waiting in a station .	a passenger train waiting at the city train station .
a white animal running through snow covered woods .	a white dog runs through a snow covered wood .
a bicycle is parked by a shop .	a bicycle is parked outside a bookstore .
a man sitting on the grass looking toward the sky .	the train is riding on the tracks in the snow .
a black , flat screen television placed on the floor .	a flat screen tv on the floor .
a silver bicycle is parked in a living room .	a bicycle in a dining room .
a orange and white cat laying on a blanket in a black leather chair .	a ginger and white cat curled up and asleep on a leather chair .
the brown dog is resting his head on a white pillow .	a tan dog is lying on a couch and has its head on a white pillow .
black train on train tracks .	a train on the train tracks .
black train on train tracks .	a train on the train tracks .
young couple sitting on a black couch .	young couple sitting on couch .
a group of black people in front of a building with a moped .	a group of people are outside a decrepit building .
an orange tabby cat sleeping on the sofa .	man wearing a bib sitting on a green couch .
elderly woman sitting on red patterned couch with her arm around younger woman .	two women sitting on couch posing for camera .
the bald eagle is perched on a rope .	two bald eagles perched on a branch .
a couple posing for a picture on a couch .	young couple sitting on couch .
the men are playing a guitar and having a drink .	there is a young boy with a red and blue jacket on feeding a sheep .
two cats sitting together on the sofa looking out the window .	two cats are looking at a window .
red double decker bus .	red double decker bus with hood up .
a close-up of an animal with a long face standing on grass near a tree .	a close-up of a woman with black boots next to a blue motorcycle .
a brown and white dog sits on a floral-patterned chair .	a small orange and white dog with a collar and a bell relaxes on a flower print pillow .
the black and brown cow is looking at the camera .	the black and white bull is looking at the camera .
a man riding on the back of an orange suv .	an african man hanging onto the back of a very full yellow van .
a group of people sitting at a restaurant table .	a group of people sitting around a table with food on it .
two sheep on to of a cliff looking at the camera .	two sheep are standing , looking at the camera , face opposite directions .
a black and white photo of an empty train station .	a black and white photo of a cat lying down .
a row of locomotives on a siding in a field .	a dark brown horse standing in a field .
a white apple computer sits on the beige carpeting of a bedroom .	an apple computer sitting on the floor .
a dog napping under a small table .	a dog sleeping under a table .
red and white bus driving down road .	a bus drives down a busy road .
a boat with four sails is sailing on water .	sail boat sailing on the water .
red sports car racing down track .	a red sports car driving quickly on a track .
a smiling woman holding a small baby .	two smiling women holding a baby .
black bird sitting on a concrete slab .	small dog sitting next to white wall .
a victory liner bus is white with red and gold stripes .	a white tour bus with red , orange and yellow stripes .
red double decker bus on side of street .	a red double decker bus on a city street .
a group of river barges with trees in the background .	a young girl wearing a bike helmet with a bicycle in the background .
the seagull is floating on the water .	large cruise ship floating on the water .
a motorcycle parked next to a car .	a bmw motorcycle parked between two cars .
a cat laying on a red cushion looking at the camera .	a tan dog lying on a moggie bed looking up at the camera .
gray cat looking out the window .	a cat looking out of a window .
a black and white photo of a cow under a tree .	a black and white photo of a cow walking under a tree in a field .
a potted plant in sunlight from a window .	a potted plant with only a few sprouting .
two green and white trains sitting on the tracks .	two green and white trains are sitting on the train track .
four people are rowing a boat near the shore .	four people are on a boat on green water .
a girl in a red shirt is riding a brown horse .	a tan and white dog laying in bed with a yellow coverlet .
two airplanes in the sky .	a plane in the sky .
a coal train traveling down the tracks .	an old train sits idle on the tracks .
there is a small desk and chair in front of the laundry room .	a room with tan walls and a washer and dryer .
an amtrak passenger train waiting at a station .	a passenger train waiting in a station .
a large jet on the ground at the airport .	a passenger jet flies through the air .
a cat looking at the camera .	a grey , black , and white cat looking at the camera .
world news headlines displayed on a large screen .	a man dressed for a race relaxes .
two women posing with a baby .	two smiling women holding a baby .
a young girl wearing a helmet riding a pony .	a girl wearing a red blouse riding a brown horse .
a grey cat lying on a wooden table .	a grey cat laying on a dining table .
people sitting on the porch .	people sitting on acouch .
two horses standing in a pen .	a group of horses grazing in a field .
a man sitting in a back yard playing the guitar .	a man riding on the back of an orange suv .
the red train and the yellow train on on the tracks .	two trains are traveling on the track .
two people sitting at a table at a restaurant .	a group of people sitting around a table on a porch .
a lamb stands near two tiny animals .	a sheep standing near her children .
a father napping in a chair with a baby on his lap .	man with pink shirt sleeping on chair with infant .
a close up head of an ostrich .	a close up of an ostrich face .
a person riding a dirt bike in the outdoors .	a person jumping a motorbike in the air .
tan cow with ear tags on a grassy field .	many sheep standing on a green hill .
green and white bird perched on tree branch .	bird with a green head and white chest perched on a tree branch .
sail boat sailing on the water .	sail boat floating on the blue water .
a red and white plane flying on a sunny day .	red and white plane flying through the air .
a man in a top hat rides a white horse .	a man with a top hat riding a white horse .
a black and white photo of an old train station .	a black and white photo of a cat sitting on a sofa .
a bicycle in front of some ruins .	a pink bicycle is in front of a building .
a woman with a viking hat on .	smiling woman sitting wearing a viking hat .
parked white double decker bus .	a red and white double decker bus is parked .
red double decker bus on side of street .	a red double decker bus on a crowded street .
a woman riding a brown horse .	a woman taking her own photo from above .
a field of black faced sheep .	a black faced sheep .
two birds are perched on a metal band .	two small birds perched on a metal bar .
a bus drives down a busy road .	a green bus drives down a road .
table with blue table cloth in kitchen .	wooden cabinets in kitchen .
an elderly asian couple pose with a yawning baby at a dinner table .	an older asian couple poses with a newborn baby at the dinner table .
brown and white ducks walking on green grass .	a red and white plane flying on a sunny day .
a young woman with a bracelet is wearing a bikini top and jeans .	a women wearing a bikini top and jeans .
a brown horse grazing in a field of green grass .	brown horse standing in middle of grassy field .
a pot of liquid is at the center of a tinfoil covered plate .	a pot of food is placed in the center of a red tablecloth .
a black and white cow standing in a grassy field .	a blue jay standing in a grassy field .
a yellow and blue airplane is flying in the sky .	the white airplane is flying in the blue sky .
two men standing in grass staring at a car .	a woman in a pink top posing with beer .
a women sitting in a chair at christmas holding make up .	a train sitting on the tracks in a train yard .
four asian young people sitting in a den or living room .	a girl sitting in a living chair .
train going down the tracks .	train gliding on tracks .
a young woman dressed in black .	two young kids dressed up sitting down on chairs .
two indian women with two indian girls near the water .	two indian woman stand with two indian girls on a beach .
group of people sitting at table with drinks .	four people sitting at a table .
a table is set with wine and dishes for two people .	a wooden table is set with candles , wine , and a purple plastic bowl .
a plane flying at a distance .	a woman with a white horse .
a group of river barges with trees in the background .	a group of cows in a field with yellow tags in their ears .
a living room with a dining table in the background .	a living room with large sofas and a dining table in the background .
yellow striped cat resting on blue sofa .	an orange tabby cat sleeping on the sofa .
a passenger train coming into a station .	a large bird is flying through the air .
two people paddling in a red canoe with trees in the background .	two people padding in a yellow canoe down a river with trees in the background .
a moped in front of ruins .	white bus parked in grass in front of building .
people ride mopeds in an urban setting .	people riding horses in a fenced area .
a black train moves down the tracks .	black train idle on the tracks .
a white jeep parked in front of a store .	a white jeep parked on a street .
two women standing in front of tour bus .	two men talking in front of a plane .
a person driving a cart pulled by a bicycle .	a man wearing a dust mask riding a three wheeled bicycle .
large silver locomotive engine in a shed .	the silver train is parked in a station .
a man rides a large black motorbike .	a child sits in a large black leather chair .
a bicycle is parked outside a bookstore .	people stand outside a bookstore .
plane in mid-flight at sunset .	a plane flying near the sunset .
two people sitting on a large motorcycle .	two eagles sitting on a long branch .
two red buses parked up with gardens in front of them .	red buses are parked by a large white building beside a formal garden .
a yellow parrot clings to the side of its cage .	a yellow and orange bird hold on to the side of a cage .
a dog sniffing the bottom of a door .	a black and white dog sniffing at a closed door .
couple sailing in a small sailboat .	two men sailing in a small sailboat .
a silver and blue motorcycle sitting next to a car .	a motorcycle parked next to a car .
red double decker bus .	a red , double-decker bus .
feet standing on a pretty day with large building in background .	two police officers standing behind a van with a bus in the background .
a small white dog chews on a twig while lying on a wooden deck .	the white dog is laying on the wooden floor underneath the table .
man standing in front of silver train .	man standing in front of a silver rail car .
a close-up of a sheep with its tongue hanging out .	close up image of a sheep with it 's tongue hanging out .
a black and white horned cow standing in a field .	a black and white cow standing in the field .
a small bird sitting on a branch in winter .	a small bird perched on an icy branch .
a yellow bird is eating fruit on a wire grate .	a yellow bird eating fruit on a bird feeder .
a man riding a white horse in an arena .	a man riding a white horse .
a brown duck and white duck stand on the grass .	brown and white ducks walking on green grass .
a black and white cat and dog on a striped couch .	a black and white cat standing in front of a window .
a train sitting on the tracks near a field .	a train traveling down the tracks .
a women and small child sitting at a dinner table smiling at the camera .	a small cat laying on a wooden beam looking up at the camera .
a buddha statue sits on a table with a wooden table runner .	a bird standing on top of a wooden fencepost .
a man wearing black formal wear & a black top hat is riding a white show horse .	a man with a top hat riding a white horse .
two red buses driving in front of a garden .	train pulling into a station .
cows grazing in a snow covered field .	five cows grazing in a snow covered field .
a man riding a white horse .	a woman riding a brown horse .
a small brown birds is eating from a bird feeder hanging from a tree .	a small bird perches on the bird feeder hanging from the tree .
this a picture of the countryside with a large city in the background .	there are some black cattle in a grassy plain with a large tree in the background .
man with blue shirt standing in front of a fountain .	a man in a blue shirt and tan pants is standing in front of a statue of a man , which is in a cobble stone paved plaza .
a girl in riding gear sits atop a brown horse .	a girl in a red shirt is riding a brown horse .
a scantily clad woman is standing next to a car .	a yellow and orange bird hold on to the side of a cage .
several televisions are on the floor and stacked up on top of one another .	three televisions , on on the floor , the other two on a box .
sheep are grazing in a grassy field near a stand of trees .	sheep are grazing in the field in front of a line of trees .
a clear plastic chair in front of a bookcase .	a clear plastic chair in front of book shelves .
a dog is wearing a gray jacket .	a dog laying in a pet jacket .
a sheep stands on a hillside .	a large sheep standing on a hill .
a black and white cow standing in a grassy field .	a black and white cow standing in the field .
blue and red plane in mid-air flight .	a blue and red airplane while in flight .
a woman in a black bikini top and jeans .	a woman in a black hat is standing by the subway .
a girl riding a brown horse .	the jockey is wearing purple and riding a brown horse .
man standing in front of yellow corvette .	a man is standing next to a yellow sports car .
three men posing in a tent .	three men eating in a kitchen .
a man sitting on the grass looking toward the sky .	the man is standing on the sidewalk in front of the horse .
a man poses in front of a large fountain with a statue on top .	man with blue shirt standing in front of a fountain .
the small dog protects its owner .	the back of the stop sign is adorned with stickers .
children looking a sheep .	child milking a cow outside .
a white cat standing on a carpet .	a sheep standing in a forest .
a flat screen tv on the floor .	a flat-screen tv sits on the floor .
a close-up of a gray cat with green eyes .	a close-up of a cat on a cream sofa .
two brown horses standing in grassy field .	two men sailing in a small sailboat .
two sheep stand in a doorway .	two rams stand on snowy ground .
a train is at a train station .	the train sits at the train station .
room with several computer monitors .	a room with four computer monitors in a row .
a line outside of a bookstore on a street .	the yellow motorcycle is parked on the street .
the train heads down the tracks and along the hedge .	a dog on the floor of a patio looks at a cat on the fence .
a passenger jet sits on a runway .	a large passenger jet flying close to the ground .
a little girl is laughing at the camera .	a white cow with big ears looking into the camera .
old green bottle sitting on a table .	three men in suits sitting at a table .
three young women standing in a room together .	three dark haired young women in white , red and black sweaters .
a black-and-white photo of a loveseat .	a black and white photo of an old train station .
the back of a stop sign with many stickers on it .	the back of a sign with stickers on .
two white horses staring over a fence .	two horses standing in a pen .
living room or den with large screen television .	living room with tan furniture and flat screen television .
the black and white cows pause in front of the gate .	the white airplane is flying in the sky .
a black and white cow standing in a grassy field .	a black and white horned cow standing in a field .
two women sitting in lawn chairs .	two women are sitting in a cafe .
a doubly decker red bus driving down the road .	a red double decker bus driving down a street .
a black and white photo of a cat lying down .	a black and white image of a cat laying on a rug .
a man and woman stand , smiling for camera .	a man and woman are posing for the camera .
a orange and white cat asleep on a leather chair .	a ginger cat sitting on an office chair .
a white cat standing on a carpet .	a pretty white striped cat with his head hanging off the table .
grey and white domestic kitten lying down on a desk .	a man and his bicycle laying down on the green grass .
a white bird with long orange legs standing by a lake .	large white bird with long orange beak standing on the shoreline .
a woman posing in front of an apartment building in the snow .	white bus parked in grass in front of building .
a young woman with a bracelet is wearing a bikini top and jeans .	a woman wearing jeans , a dark bikini top , and a bracelet .
a red train driving through a snow covered city .	the train is riding on the tracks in the snow .
a table and chairs are in a room with a picture on the wall and a ceiling fan .	a school bus driving down a road with green trees and grass in the background .
the black bird is sitting on the ground .	the back of a pig under a tree with a cow in the background .
a man sits crossed legged on a bed watching a small tv .	a man sits on a bed very close to a small television .
a das air cargo plane sits on the runway .	a passenger plane parked on a runway .
the headlights on a blue car .	close up of the headlights on a blue car .
a cat sleeps on purple sheet .	a black and white cat sleeps on a purple blanket .
a passenger train coming into a station .	a passenger train sits in the station .
a close-up of a cat on a cream sofa .	a close-up of a horse .
three bicyclists crossing a bridge in a city .	the bicyclists are crossing a bridge in the rain .
a red and white bus drives down an england street .	a red and white england bus drives down the street .
an airplane facing the camera .	a lone cow sits in the cold of the yard .
a woman riding a brown horse .	a person dressed in white on a brown horse .
a jockey riding a horse .	a jockey riding a horse in a pen .
the two dogs blend in with the stuff animals .	two dogs sit on a couch with many stuffed animals .
a kitchen with wood cabinets and dining table .	a kitchen with wooden cabinets and furniture .
a train is running on the tracks .	a train is running down the track in a rural area .
a motorcycles is parked near a wall covered with a graffiti scene of a cityscape .	a motorcycle is parked by a mural of a city in the evening .
someone standing on a snowy mountain , watching a plane .	a man stands on a mountain , watching a plane .
the birds are swimming in the water .	birds fly low over water .
a bird is flapping its wings in the water .	a large black bird is sitting in the water .
a black dog looking at the camera .	the black and white bull is looking at the camera .
a cruise liner docked at a port .	a cruise ship docked at a coast .
a red double decker bus on a crowded street .	a white bus partially in the snow on a public street .
a woman pets a dog in a fenced area .	a woman pets a dog in a gated yard .
a black and white cat playing with a blanket .	a black and white cat gets into a basket of yarn .
a man on a mountain bike going down an incline .	this is a man riding a mountain bike over rocks on a clear day .
a cat reclines on an office chair .	a ginger cat sitting on an office chair .
a group of horses grazing in a field .	a brown horse grazing in a field of green grass .
a group of people having a drink .	a row of locomotives on a siding in a field .
two dogs in a fenced kennel look ahead .	two woman pose in a dining room with a baby .
three sheep on a dirt road viewed from a passenger vehicle .	three sheep in middle of gravel road .
a yellow and blue airplane is flying in the sky .	nine red and white aircraft flying in formation trailing smoke .
the train sits at the train station .	the blue train is at the station .
a train sitting on the tracks near a field .	a baby is sitting in the grass .
red double decker bus taking on passengers .	a red double decker bus is picking up more passengers in a city .
two guys sit on a couch holding beers with a girl lying on their laps .	two women watching the street with their bikes to see when they may cross .
two women in the kitchen looking at a object .	two women in kitchen with one taking a picture .
a race horse galloping without a rider .	a horse galloping while wearing the number 4 .
a steam engine and train moving toward the camera .	a large bird of prey flying towards the camera .
a group of horses grazing in a field .	group of horses grazing in grassy field .
a black and white photo of a glass bottle of coca cola .	this is a black and white picture of a short squat coca-cola bottle .
a small bird perched on an icy branch .	a yellow bird perched on a branch .
several people on motorcycles in a market square .	people on motorbikes in a city street .
three sheep on a dirt road viewed from a passenger vehicle .	three sheep on a dirt road shot from a car .
boy with glasses typing on a computer .	a boy looking at a computer screen .
group of people posing with two men dressed as elvis .	a group of people standing with two other people dressed as elvis .
a red truck spins their tires while a black one leaves the frame .	red truck spinning tires and emitting smoke from behind .
a living room with table , chair and sofa alongside a large palm .	a living room with a blue sofa , camp bed , wooden bench and dresser .
a smiling woman holding a small baby .	a woman sitting on a sofa holding a baby .
an esso gas station with trees in the background .	two police officers standing behind a van with a bus in the background .
four blue and yellow planes flying over four boats .	four blue and yellow planes in flight .
a horse standing near a gate with another horse in the background .	a group of river barges with trees in the background .
three bottles are on a table .	old green bottle sitting on a table .
two boys sit facing one another at a table and one points at the other .	two people sit facing each other at a table as one points at the other .
a steam engine comes down a train track near trees .	a train is at a train station .
a train is at a train station .	a train parked at a train station .
two white dogs are swimming in the water .	the birds are swimming in the water .
parrot pushing a small shopping cart .	a white bird is steering a shopping cart .
a woman sitting on a sofa holding a baby .	bird sitting on a log in a lake .
man in yellow canoe paddling through water .	man paddling a yellow canoe towards a the shore .
two birds flying towards water feeder .	two birds flying near bird feeders .
two cows standing in a large field .	horse standing in a field .
beer bottles ( -lrb- harp lager ) -rrb- lined up on the floor .	a row of beer bottles on the floor .
two women sitting outside laughing .	two women standing outside of a bus .
a group of sheep grazing on a hill .	a group of sheep are on a hill .
a man stands in front of a train .	a man is standing in front of a raised statue , .
a steam engine and train moving toward the camera .	a white sheep on a hillside looking at the camera .
two women are posing for the camera and giving the thumbs up sign .	two smiling young women giving the thumbs up sign .
a women holds a small baby while sitting on a sofa .	a woman sitting on a sofa holding a baby .
a double decker red united bus on a city street .	a doubly decker red bus driving down the road .
two women sitting on brown couch .	two women standing outside of a bus .
a grey cat with green eyes looking into the camera .	a grey , black , and white cat looking at the camera .
the bird is sitting on the branch .	the sheep is standing under the trees .
group of people sitting at table of restaurant .	two people sitting at a table at a restaurant .
a black and white cow stands on grass against a partly cloudy blue sky .	two black and white cows behind a metal gate against a partly cloudy blue sky .
a brown and white cow in a field looking into the camera .	the black and white cat is looking up at the camera .
a guy on a white horse .	a man riding a white horse in an arena .
two dairy cows drinking from a pond .	two cows are drinking from a pond .
there are several sheared sheep in a pen .	three white sheep in an enclosure .
black and white cow standing near pile of snow .	a black and white cow standing in the field .
the black dog is lying in the grass .	a black dog lies on the grass .
home office space with bright green walls and artwork .	an office with multiple desks and green walls .
large white cruise ship floating on water .	large cruise ship floating on the water .
two young people are sitting at a table next to a sliding glass door , with one person pointing at the other .	two people sit facing each other at a table as one points at the other .
a black and white photo of a man driving a car and someone with a motorcycle .	a black and white photo of a man in a classic car and a man with a classic motorcycle .
a man and a woman holding hands walking along the beach .	a man with a beard and a skullcap and a boy walk along the ocean 's shore .
ten sheep looking at the camera .	a cat on its back looking at the camera .
a black and white dog looking at the camera .	a small black and white goat in a pen looking up at the camera .
a black table with white fuzzy chair .	a woman with her child .
red double decker bus taking on passengers .	a red double decker bus driving down a street .
sail boat sailing on the water .	sailboat sailing on a cloudy day .
a blue bird perches on the gloved hand of a person .	a bird is perched on a person 's gloved hand .
three people are by the water with yellow canoes .	three people preparing to canoe .
a girl riding on a brown and white horse .	a girl riding a brown horse .
a mostly black train on a track .	a car parked in front of train tracks .
a young boy coloring with a red and blue crayon .	a young blonde girl in riding gear sits on top of a gray and white horse .
two bald eagles perched on a branch .	two eagles are perched on a branch .
a backpack standing beside a train .	a social gathering of people in a restaurant .
a group of people in a living room .	a group of four people walking past a giant mushroom .
a mallard and a tame white duck on the grass near water .	a small child in a pink dress sits on a table .
the cat is sitting between two bicycles in front of a door .	than horse standing in a field in front of a fence .
a girl with a red bag standing on the street .	a black dog is staring at a sheep .
a girl in a riding hat on a horse .	a girl riding a tan horse .
a horse rider is riding a white horse .	a woman leading a white horse .
a man dressed in a pale scarf with a stick .	a runner is resting in the shade with a bottle of soda .
the bird is sitting on the branch .	a red and brown bird is perched on branches .
a long train is on train tracks .	a train on the train tracks .
a black and tan dog looks at a black sheep .	a black dog looking at a brown sheep in a pen .
a room with several computers and pictures on the wall .	a home office with three computer monitors and other equipment on a desk .
a very retro living room with a television in it .	a grey cat lying on a wooden table .
a black and white photo of a cow walking under a tree in a field .	a black and white dog looking at the camera .
a silver areomexico jet liner sitting on the tarmac .	an aeromexico silver plane is on a runway .
a man on a dirt bike jumping very high .	a man on a motorbike jumping with the sky behind him .
a girl in a riding hat on a horse .	a girl riding a brown horse .
two people sailing a small white sail boat .	couple sailing in a small sailboat .
a white airplane is parked on the cement .	a blue motorcycle is parked on the sidewalk .
a group of peoples posing in fur hats .	a group of cyclists in green and white with spectators looking on .
three cows grazing in a field .	several sheep grazing in the field .
a car is pulling off the side of the road onto the street .	a silver car parked on the side of the road in front of the hills .
the man is sitting at a messy table and using a laptop .	a man sits looking at a laptop computer on a messy table .
black domestic cat lying on brown table .	a grey cat laying on a dining table .
a dining table with candles , wine , and a teapot .	a wooden table is set with candles , wine , and a purple plastic bowl .
four children looking at barn animals .	children looking a sheep .
a black and white cat playing with a wool basket .	a black and white cat lying on a blanket .
two people paddling a red canoe are reflected in the still water .	two people in a red canoe on a clear lake .
a scantily clad woman is standing next to a car .	a scantily clad woman standing next to a small red vehicle .
red double decker bus taking on passengers .	red double decker bus with hood up .
the man is sitting cross legged wearing a cloak and holding a stick .	man sitting cross legged while wearing a brown cloth and holding a wooden stick .
a buddha statue holding a candle is sitting on a table .	a man fishing on a small boat while on a lake .
two black and white dogs at the bottom of stairs .	a dog is lying at the bottom of a staircase next to another standing dog .
three people sitting at dinner table smiling at camera .	two elderly women sit at a dinner table with a man .
a multi-colored train on a track .	a mostly black train on a track .
a white and red bus traveling on the street .	the red bus is on the street .
a red and blue plane flying with its landing gears down .	a wwii fighter plane with its landing gear down .
small boat going down a creek .	a boat moving in a river .
four women and two men sit at a long table in a restaurant .	a group of people sit at a table in an italian restaurant .
an old fashioned wooden sailing ship in the ocean .	an old fashioned wooden sailing ship is parked at the pier .
two goats standing in a field by a tree .	a large boat pulling a small white boat .
a man sitting cross legged on the grass , with a tree in the background .	ocean liner close to coast with houses in the background .
a black and white photo of a living room with a large window , sofa , and chair .	a black and white scene of a well furnished room with a view outlooking a forest .
close up of a brown horse with a blue halter .	a close up of a horse wearing a blue halter .
a large black bird is sitting in the water .	the birds are swimming in the water .
a close-up of a cat on a cream sofa .	a siamese cat resting on a white sofa .
a person is jumping a bicycle and performing a trick .	a person riding a dirt bike in the outdoors .
a yellow school bus is parked in a rural area .	a yellow school bus parked in a field .
a pug dog wits on a yellow chair next to a green dumpster .	a bulldog sitting on a yellow chair beside a large waste receptacle .
the woman is sitting on the red motorcycle .	the white sheep is standing on the green hill .
a sheep standing on a table at auction .	woolly sheep at auction house .
a close-up of a black train engine .	close up of a white sheep with a black head .
a orange and white cat asleep on a leather chair .	a orange and white cat laying on a blanket in a black leather chair .
a train rides on his tracks .	the train comes down the track , between two rows of trees .
two men on boat floating on the water .	a wooden yacht on the ocean .
black and white cow standing in grassy field .	a black and white horned cow standing in a field .
a double decker red united bus on a city street .	a double decker bus drives on a city street .
two cats sitting on a couch looking out the window .	a cat looking out of a window .
the television and desk of hotel room with lamp lighting .	a television and a laptop computer are on in a hotel room .
a man riding a small bicycle .	a man is doing a wheelie on a bike .
three goats are being rounded up by a dog .	three goats are chased by a dog .
a woman wearing a navy dress is cutting a cake on a white table .	a person wearing a helmet sits on a bicycle on a sunny day .
a man doing a wheelie on a mountain bike .	a woman posing by a pillar with a u2 sign .
a tan puppy on a carpeted floor .	tan puppy lying down on white carpeting .
a black train moves down the tracks .	a train traveling down the tracks .
a close-up picture of a white and purple motorcycle .	a close-up picture of a desk with a computer and papers on it .
a young girl riding a brown horse .	a woman in riding a brown horse .
a black dog standing in a grassy area .	a long-haired dog stands in a grassy wooded area .
two women in the kitchen looking at a object .	three men in suits sitting at a table .
two women posing with a baby .	a woman poses with a baby .
a group of people sitting around a table containing food .	four people are sitting around a living room with.snacks.
train in a station .	a train in a station .
a blue motorcycle is parked on the sidewalk .	a blue moped parked on the sidewalk .
a blue bird standing on a lawn .	blue bird standing on green grass .
a red double decker bus on a city street .	a red double decker bus driving down a street .
two trains inside a train station .	the train sits at the train station .
a woman equestrian riding a horse .	the woman is riding on the brown horse .
an empty office cubicle .	an empty office chair in a cubicle .
a man riding a white horse .	a woman with a white horse .
train going down the tracks .	a black steam train traveling on the railroad tracks .
a man and two women smiling at the camera while sitting on a blue sofa .	a man and women smiling at the camera while standing in a kitchen .
a man and woman sit at a table in a restaurant .	four women and two men sit at a long table in a restaurant .
a young man wearing a striped shirt is holding two bicycles .	young redheaded man holding two bicycles near beach .
a large cruise ship in harbor with trees behind .	a cruise ship docked at a coast .
a white plane on the runway .	a white swiss airplane approaches the runway .
two cows crossing a road intersection .	two cows cross a paved street .
several cows grazing on the median by the road .	five cows grazing on a patch of grass between two roadways .
a television , upholstered chair , and coffee stable in a bright room .	a leather couch and wooden table in a living room .
the white ducks are standing on the ground .	a woman in a black hat is standing by the subway .
a black cow and a brown cow stands in a plain in front of an uprooted tree .	a black cow and a brown cow standing in front of a small copse of trees in a field .
red double decker bus driving down street .	a double decker bus on a city street .
a group of people eat at a table outside .	a group of people sitting at a restaurant table .
tan cow with ear tags on a grassy field .	person in grassy field tending to sheep .
a close up of the front end of a purple and white motor cycle .	close up of the rear of a red sports car .
two women shopping at a clothing store .	two women in a clothing store .
a group of people sitting at a restaurant table .	group of people sitting at table of restaurant .
a close-up of a brown horse 's head .	a close-up of a yellow school bus .
a person in a red cap standing next to a brick support beam .	a brown horse is standing on grass and scrub .
a bay foal is walking next to its mother in a grassy field .	close-up of young horse walking next to a larger horse .
a women standing next to a brown cow .	a women in glasses stands next to a cow in a field .
two cats sitting on a couch looking out the window .	two cats are looking at a window .
a dog peaks out the back of a truck .	a dog is peeking out of the back of a van .
woman in blue shift dress cutting into food .	a woman in a blue dress cuts a cake .
the black and white cat is looking up at the camera .	a grey , black , and white cat looking at the camera .
two brunette girls sit atop a red an yellow motorcycle with a side car .	a couple posing on a red and yellow motorcycle .
a small white cat standing in a sink .	grey and white cat sitting in bathroom sink .
a man on the back seat of a red tandem bicycle .	a man is alone on the back of a tandem bicycle .
the small dog is wearing a sweater and looking up at the camera .	a small white dog wearing a jacket looks up at the camera .
two men standing in grass staring at a car .	two women sitting in chairs in a shop .
a computer on a desk .	a computer operating on a desk .
a small child smiling at the camera .	a small child sits on a cement wall near white flower .
a little bird floating in the water .	a duck floating in the water .
a woman stands in front of a building in the snow .	two women and a baby pose in front of a dining room .
a white bus with the word julia is near water and a big ship .	a white bus with water and a barge in the background .
home office space with bright green walls and artwork .	small office space with bright green walls .
old blue and white train on tracks .	a blue train in a mountainous area .
young baby girl sitting on table .	a woman with a smiling baby sitting on the table .
a green car parked at a saloon .	a green car parked outside the saloon .
yellow boat on a beach .	a yellow boat on shore .
group of people sitting around a restaurant dining table .	a group of people sitting at a restaurant table .
a kitchendiner with papers laying on the blue clothed dining table .	a small kitchen and a cluttered table with a blue table cloth .
train in a station .	trains inside an indoor station .
a gray cat is sitting on the window ledge looking at the camera .	the cat is standing on the window sill looking at the camera .
two ducks are standing by the water .	the birds are swimming in the water .
a black and white cow in a pen with hay .	black and white cows behind a fence .
man playing guitar while sitting down .	red and white bus driving down road .
a man and woman are posing for the camera .	a cat sitting on sand looking up at the camera .
red double decker bus driving down a street .	a double decker bus on a city street .
a green and white cargo plane taking of from an airport .	white and green commercial airliner taking off of runway .
three cows are grazing in a grassy field .	three cows grazing in a field .
the brown train is sitting on the railroad tracks .	the white train is sitting on the tracks .
a black and white horned cow standing in a field .	a black and white photo of a cat sitting on a sofa .
two cats are close together inside and black and white furry enclosure .	two baby kittens are sitting inside a cow-schemed , fur-covered dome .
a tiny blonde child in a blue dress sits on a table near her mother .	a young blonde girl wearing a helmet sits with a red bicycle behind her .
a group of people sitting at a restaurant table .	a group of people sitting around a table on a porch .
a black and white cow in a pen with hay .	a black and white cat lies in the dirt .
a red , double-decker bus .	front and left side of a red double decker bus .
a yellow school bus parked in a field .	a brown horse in a green field .
a close-up view of a horse 's head .	a side view of a horse 's head .
an elderly man works on his laptop at home .	older gentleman sitting on couch with laptop .
an old fashioned wooden sailing ship in the ocean .	a wooden yacht on the ocean .
a sheep standing in a mountainous area .	a large sheep standing on a hill .
a group of people sitting on a small sofa next to a kitchen .	a group of people standing near a small child sitting on a horse .
a white plane on the runway .	a white airplane is on a runway .
a tan puppy being petted .	a tan puppy being held and petted .
the cat is sitting on a bag of cat food .	two eagles sitting on a long branch .
elegant dining room with wood furniture .	an elegant pink dining room with wooden furniture .
a women laying across two men sitting on a sofa .	two men in shorts are sitting on a sofa .
two motorbikes on a dirt track .	two dirt bikers riding over dirt hill .
a man jumping his dirt bike .	a man on a bike jumping through the air .
the black and white cat is looking up at the camera .	a black and white dog looking at the camera .
a large pile of wooden items piled high .	a large pile of scrap wood .
a gray cat with green eyes looks at the camera .	a grey cat with green eyes looking into the camera .
two lambs stand on a grassy hill .	two dirt bikers riding over dirt hill .
a black and white photo of a bottle sitting atop a rock carving in front of a line of bushes .	a bottle of water sitting on a stone with other stones and a wall in the background .
a woman riding a brown horse .	a girl riding a brown horse .
black and white photo of a girl on a sofa .	a black and white photo of a cow under a tree .
a black and white cat is sitting on a brown chair looking up .	black and white cat sitting on wood chair looking up .
a black and white horned cow standing in a field .	a large black and white cow in a field .
a man in white with a wine bottle and a woman in a red turtleneck with a white vest .	a man and woman posing on a field with a bottle of wine .
a lone cow sits in the cold of the yard .	a black and white cow standing in the field .
a double decker bus drives on a city street .	a red double decker bus driving down a street .
large black and white cat resting on a windowsill .	a small white cat sitting in a sink .
boy feeding a sheep .	a boy feeding a sheep hay .
a black dog stands next to materials at a construction site .	a black dog stands in the middle of a construction site .
a girl in a black desktop holds up an open box of corn flakes and a carton of milk .	a girl wearing black shorts and boots is standing next to a blue motorcycle .
a close up of a small cactus in a pot .	a close up of a woman holding a white puppy .
the white sheep is standing on the green hill .	a sheep stands on a hillside .
a long-haired man with a hat standing between two large , half-empty coke bottles .	a man with a cap and jacket walking between two large bottles .
a black and white bird on a body of water with grass in the background .	a bus is on a road with a ferris wheel in the background .
a wooden bicycle with an awning .	a group of elderly people sitting around a dining table .
a black and white photo of a dilapidated wooden fence .	a black and white photo of an old wooden fence near a dirty street .
two women sitting in chairs in a shop .	two women are sitting in a cafe .
two brown horses standing in a green meadow .	a brown horse stands in tall grass .
two men wearing bike helmets .	two men stand with their bicycles outside a shop .
an aeromexico jet taxing along a runway .	a silver areomexico jet liner sitting on the tarmac .
a red bird and four other birds sitting in the snow .	five birds stand on the snow .
a women painting a chair with a dining room in the background .	a man and boy walking along a beach with the sea in the background .
a man playing a video game in a store .	man playing game in a store .
a group of people sitting around a table on a porch .	a group of people sitting around a table with food on it .
an older asian couple poses with a newborn baby at the dinner table .	a group of elderly people pose around a dining table .
a young girl wearing a bike helmet with a bicycle in the background .	a women holds a small dog on a leash with chairs in the background .
the back of a stop sign with many stickers on it .	the back of the stop sign is adorned with stickers .
a bicycle is parked outside a bookstore .	a green bike parked outside a book store .
a brown double decker tour bus on a street with a ferris wheel behind it .	a double-decker bus driving in front of a ferris wheel .
a black and white chair sitting in front of a brick wall and a window with a bamboo plant in a vase .	a black headed sheep covered in thick white wool stands in a pasture with other sheep .
domestic cat looking out window .	a white cat looking out of a window .
two cows graze in a field .	a brown horse in a green field .
a man in a black uniform on a white horse .	a man in a tux on a white horse .
a cat sleeping on the coach with a pillow behind it .	the cat is laying on an animal print blanket .
two women stand in a living room with a black dog .	two women standing in a living room with a black dog looking towards the camera .
two motorbikes racing on a dirt course .	two motorbikes on a dirt track .
two people paddling a red canoe are reflected in the still water .	two people paddling in a red canoe with trees in the background .
a close-up view of the headlights of a blue old-fashioned car .	close up of the headlights on a blue car .
a person is standing underneath an overpass near a highway .	a person walks a dog along the water 's edge .
cars driving near a model building .	vehicles driving infant of an ornate building .
a woman and child push strollers down the sidewalk .	a women and a young girl walking pushchairs along the sidewalk .
a blue and orange airplane flying with its landing gear down .	a red and blue plane flying with its landing gears down .
a young woman is riding a bay hose in a dirt riding-ring .	a man is staring at a horse with a white mane .
a white bird flying up onto a tree .	a white cat laying on a sheet .
a black and white cat lying on a blanket .	a black and white cat sleeps on a purple blanket .
a building with a temporary sign over the entrance to its parking lot .	road with the rear image of the tail lights of a bus .
a group of people sitting around a table containing food .	a group of people sitting around a table on a porch .
a man and women sitting on a sofa holding a small baby .	a woman sitting on a sofa holding a baby .
a black and white cat lying on a blanket .	a black and white cat sleeping on its side on a purple blanket .
a black and white photo of a love seat .	a black and white photo of a bicycle .
a living room with a dining table in the background .	view of a living room with a dining room in the background .
a woman at the dining table with wine , beer , and lemons .	four women and two men sit at a long table in a restaurant .
a red and gray train is going through a tunnel .	a red and gray train travels through a tunnel amongst the trees .
red double decker bus with hood open .	an old red london double decker bus with its hood raised .
a laptop computer and a computer monitor .	a laptop and a pc at a workstation .
a man riding a white horse .	a woman leading a white horse .
view of a living room with a dining room in the background .	a living room with large sofas and a dining table in the background .
an orange kitten lay on a leather couch .	young couple sitting on a black couch .
a white cat laying on an office chair .	a white cat laying on a sheet .
a small yellow boat sitting on a tropical beach .	a small girl sits on a stone ledge near a white flowering plant .
two women are sheering a white sheep inside of a wooden building .	two women shearing a white sheep in a wooden stall .
a person wearing a bike helmet talks on a cell phone .	a person wearing a helmet rides a bike near a white structure .
a subway train pulling into the station .	a white train pulling into a station .
a bicycle is parked by a shop .	a green bike parked outside a book store .
two men standing on beach .	two women standing in front of tour bus .
a man with glasses and two plastic bottles in the foreground .	a man talking with two water bottles sitting in front of him .
long-haired black dog standing in grassy field .	a blue jay standing in a grassy field .
a small desk with chair near a laundry closet .	a room with tan walls and a washer and dryer .
red double decker bus driving through the streets .	red double decker bus driving down a street .
a goose flapping its wings in a body of water .	a black swan flapping its wings on the water .
a gray cat laying on a brown table .	a grey cat lying on a wooden table .
motorcycle parked next to a car outside .	a motorcycle parked next to a car .
a close-up of a brown horse .	a close-up of a horse .
boy laying on couch with dog .	the boy is lying on a couch with a puppy .
a black and white image of a cat laying on a rug .	black and white picture of a cat laying on a rug .
a large jet on the ground at the airport .	a large airplane parked at the airport at night .
a pile of used wooden building materials with a chair on top .	pile of wooden debris with chair on top .
two women are sitting in a cafe .	two men catching a fish in a swamp .
eight bottles of harp lager lined up on the floor .	eight bottles of harp beer lined up on a wooden floor .
an office with multiple desks and green walls .	small office space with bright green walls .
a woman leading a white horse .	a man in a tux on a white horse .
a small child smiling at the camera .	a cat looking at the camera .
a woman riding a brown horse .	person dressed in blue riding brown horse .
photo of a television screen showing a movie .	the wall-mounted flat-screen tv is showing a movie .
a bird perched on a flowerpot .	bird perched on a flowerpot beside a stucco wall .
white cat sitting inside of a sink .	grey and white cat sitting in bathroom sink .
young woman in riding gear on top of horse .	young girl in riding gear on a horse .
two people are sailing a small boat .	two women in a sailboat .
a small bird on a tiny branch .	a small bird perched on an icy branch .
two animals sitting on a rock .	two eagles sitting on a long branch .
two cats sit on the back of a couch looking out the window .	two cats are sitting on the back of a couch and looking out the window in a sea photo .
a man on a motorcycle performing a wheelie .	motorcyclist performing a wheelie next to a car .
a passenger train waiting at the city train station .	a passenger train with a yellow engine .
two young women shear a sheep .	two women sheering a sheep .
left side of a silver train engine .	a close-up of a black train engine .
the young rider takes a ride on the brown horse .	a young female rider on a brown horse .
six people are seated at a restaurant table and looking into the camera .	a group of people sitting at a restaurant table .
little white lamb with nose to wood .	a white lamb with its nose against a wooden box .
a black train moves down the tracks .	a long train is on train tracks .
a philips flat-screen tv is shown with its two remote controls .	a phillips flat screen tv with two remote controls .
a cruise ship is in front of a docking area .	calico cat sitting on step in front of a door .
a young girl riding a white and grey horse .	a little girl is riding a white and grey horse .
a black dog stands next to materials at a construction site .	a black dog standing in a room being constructed .
blue couch and twin bed in a living room .	a leather couch and wooden table in a living room .
a bird is flapping its wings in the water .	a black swan flapping its wings on the water .
a black and white cow standing in hay looks back at the camera .	there is a black and white sheep standing on the grass .
a black and white cat lying on a blanket .	a black and white cat laying on a cat bed .
young woman in riding gear on top of horse .	the woman is riding on the brown horse .
a plane being readied for take-off .	a small turboprop plane being loaded on the tarmac .
a white leather couch with a purse and throw blanket on it .	a television with a show on .
four people rowing down a river .	four people row a canoe in water .
a dark brown horse standing in a field .	a brown horse in a green field .
a kitchen with wooden cabinets and furniture .	kitchen with wooden table and cabinets .
a white bicycle stands on a floor .	old style bicycle parked on floor .
a bird eating from a bird feeder .	a yellow bird eating fruit on a bird feeder .
black bird sitting on a concrete slab .	black bird standing on concrete .
two men talking in front of a plane .	two men talking in front of a small plane .
dark colored dog standing in grassy field .	a grey dog standing in a grassy field .
a young blonde girl wearing a smile and a bicycle helmet .	a young girl wearing a bike helmet with a bicycle in the background .
two cats , one brown and one white laying on a bed with a blue blanket .	two cats , one ginger , the other white laying on a bed .
the cat is attacking a corn husk broom .	grey and white cat sitting in bathroom sink .
the train sits at the train station .	a train parked at a train station .
a couple holds a baby .	couple with newborn baby .
a small bird eating from the feeder .	bird eating from a bird feeder .
close up of a white sheep with a black head .	a close-up of a sheep with a black head .
two brown horses standing in grassy field .	brown horse standing in middle of grassy field .
a young boy laying on a sofa with a dog .	a small boy laying on a sofa with a dog .
a red bird is perched in a tree .	a small red and grey bird perched in a tree .
two buses parked on a street .	yellow scooter parked in an alley way .
a black and white dog looking at the camera .	a grey , black , and white cat looking at the camera .
two animals sitting on a rock .	the brown train is sitting on the railroad tracks .
a train is on the railroad tracks .	a train on the train tracks .
boy lying on couch with small white dog .	a small boy laying on a sofa with a dog .
large silver locomotive engine in a shed .	a close-up of a silver train engine with a red stripe .
a women sitting at a table drinking with a basketball picture in the background .	a woman in a sari drinks something while sitting at a table .
a green steam engine traveling on the railroad tracks .	a black steam train traveling on the railroad tracks .
a small red car on top of a semi truck .	red sports car on top of white semi truck .
the man poses for a photo in front of the train .	a man stands on a platform in front of a silver train .
a bicyclist in black on a black and red racing bike .	a cyclist in black and white lira speeding past spectators .
a kitchen sink and countertop with bowls on shelves .	a small kitchen with items stacked on the shelves and on the counter .
a woman is laying down on the floor and holding a baby up above her .	a man is laying on the floor holding a baby up above him .
a black and white cow looking through the fence .	a black and white dog looking at the camera .
a television in a messy room with several bookcases .	a room with a television , stereo and bookshelf .
a black and white cat sleeping on its side on a purple blanket .	a black and white cat laying on the ground in the sun .
a woman riding a bicycle on a large concrete area .	a women riding a mountain bike on a large concrete area .
two cows standing in a large field .	the cow is grazing in a field .
a bald man touches the nose of a black horse on the other side of a fence .	a bald man with a beard pets the nose of a black and white horse at the fence .
a man is standing next to a yellow sports car .	a man stands next to a yellow corvette .
a grey house with a red door .	house with a red door .
two women in a clothing store .	two women in a sailboat .
a woman with a white horse .	a woman leading a white horse .
a black and white photo of cows in their stalls .	a black and white photo of cattle at a trough .
older gentleman looking at red motorcycle .	a man looking at a red motorcycle .
depressed woman sitting on couch .	older woman holding newborn baby .
double decker bus with the london eye ferris wheel in background .	a brown double decker tour bus on a street with a ferris wheel behind it .
a yellow and black bird eats from a bird feeder .	a flock of birds flying over a body of water .
black and white cows grazing in a pen .	two black and white cows drinking out of a pond .
a small camouflaged airplane parked in the grass .	a small dog wearing a pink shirt tied to a railing .
a man stands in front of a train .	a man stands on a platform in front of a silver train .
a small plane parked at an airfield with a cloudy sky overhead .	a small white plane parked in an airport on a cloudy day .
a boat is on the water near a small plane .	a boat is in the water and a small airplane is on the dock .
a man riding a white horse in an arena .	a domestic animal stands in a pen .
a macintosh computer sitting on the floor .	a computer on the floor .
an elderly woman catches a ride on the back of the bicycle .	the boats are on the water located in front of the mountain .
a black and white cat is sitting on a brown chair looking up .	a dog sitting on a yellow chair next to a green dumpster .
sheep standing in afield .	a large dog stands next to a sheep in a field .
group of elderly people sitting around a table .	a group of elderly people pose around a dining table .
a black and white photo of a love seat .	black and white photo of couch with purse at one end .
three women with brown hair are smiling .	three women in indian dresses in a crowded room smiling .
a black and white photo of an empty train station .	a black and white photo of a cat sitting on a sofa .
the brown and white cows are eating in the trough .	brown and white cows are eating from a trough .
two dogs in a fenced kennel look ahead .	two girls on a guy posing on the bow a boat .
black bird standing on concrete .	blue bird standing on green grass .
a black and white cow looking through the fence .	a black and white cat laying on the ground in the sun .
several people on motorcycles in a market square .	people ride mopeds in an urban setting .
a close-up of a sheep in the grass .	a close-up of a lamb with its ear tagged , standing on grass .
domestic cat laying on back of cat litter .	tan domestic cat under black tarp .
crowd of people walking past a giant mushroom .	a group of four people walking past a giant mushroom .
two green birds fly towards a wooden telephone pole .	two green birds flying above the telephone wires .
a person sitting on a motorcycle while a man stands by .	a man stands next to a helmeted man on a motorcycle in an empty parking lot .
three cows grazing in a field .	two cows graze in a field .
a young woman with outstretched arms stands in front of a " going places " bus .	tthe girl is standing in front of the open door of the bus .
a sheep beside a road and a lake .	a sheep is on the edge of a road with a lake and a mountain in the background .
black and white cow standing in grassy field .	a black and white photo of a man standing next to a bus .
a blue bird perched on a gloved hand .	a bird is perched on a person 's gloved hand .
a group of people having a meal outside .	a group of people eat at a table outside .
a baby holds a ketchup packet .	a baby in a highchair holds a ketchup packet .
a close-up view of a horse 's head .	a close-up of a brown horse 's head .
two cats sitting together on the sofa looking out the window .	two cats sit on the back of a couch looking out the window .
a train is at a train station .	a train in a station .
a dark brown horse standing in a field .	horse standing in a field .
a man sitting on a bench looking at a dog on a leash sitting on sidewalk .	a women holds a small baby while sitting on a sofa .
a small cat laying on a wooden beam looking up at the camera .	the small dog is wearing a sweater and looking up at the camera .
the black bird is sitting on the ground .	the bird is sitting on the branch .
a group of people sit at a table in an italian restaurant .	a group of six people sitting at a table with salad served .
tan cows look closely at the camera .	a white and grey cat in a bathroom sink looking at the camera .
a blue scooter parked on a sidewalk .	a blue moped parked on the sidewalk .
older woman holding newborn baby .	a woman sitting on a sofa holding a baby .
a small brown birds is eating from a bird feeder hanging from a tree .	a small red and grey bird perched in a tree .
